대수,국회의원코드,국회의원명,국회의원한자명,정당명,선거구명,발의수(전체),발의수(대표발의),발의수(공동발의),원안가결(전체),수정가결(전체),철회(전체),부결(전체),수정안반영폐기(전체),대안반영폐기(전체),폐기(전체),임기만료폐기(전체),회기불계속폐기(전체),기타(전체),원안가결(대표발의),수정가결(대표발의),철회(대표발의),부결(대표발의),수정안반영폐기(대표발의),대안반영폐기(대표발의),폐기(대표발의),임기만료폐기(대표발의),회기불계속폐기(대표발의),기타,원안가결(공동발의),수정가결(공동발의),철회(공동발의),부결(공동발의),수정안반영폐기(공동발의),대안반영폐기(공동발의),폐기(공동발의),임기만료폐기(공동발의),회기불계속폐기(공동발의),기타(공동발의)
제18대,ERX2058H,김충조,金忠兆,통합민주당,비례대표,389,14,375,3,19,6,0,0,135,36,190,0,0,1,1,0,0,0,4,1,7,0,0,2,18,6,0,0,131,35,183,0,0
제18대,8BY8620U,이용희,李龍熙,자유선진당,충북 보은군옥천군영동군,315,7,308,6,11,7,0,0,76,16,199,0,0,0,1,0,0,0,3,0,3,0,0,6,10,7,0,0,73,16,196,0,0
제18대,IQN7588X,이은재,李恩宰,한나라당,비례대표,416,43,373,8,14,7,0,0,107,23,257,0,0,0,1,0,0,0,13,3,26,0,0,8,13,7,0,0,94,20,231,0,0
제18대,K8Q3437F,최규식,崔奎植,통합민주당,서울 강북구을,332,33,299,1,2,1,0,0,99,20,209,0,0,0,1,0,0,0,10,3,19,0,0,1,1,1,0,0,89,17,190,0,0
제18대,LBC8144B,김영선,金映宣,한나라당,경남 창원시의창구,185,52,133,1,16,5,1,0,44,20,98,0,0,0,4,0,0,0,8,6,34,0,0,1,12,5,1,0,36,14,64,0,0
제18대,ZA54991S,안민석,安敏錫,통합민주당,경기 오산시,1058,35,1023,120,16,7,1,0,283,166,465,0,0,0,0,0,1,0,10,0,24,0,0,120,16,7,0,0,273,166,441,0,0
제18대,LZQ7860L,이성헌,李性憲,한나라당,서울 서대문구갑,868,98,770,10,42,3,1,0,277,78,457,0,0,2,2,0,0,0,32,12,50,0,0,8,40,3,1,0,245,66,407,0,0
제18대,IUZ2177I,정수성,鄭壽星,무소속,경북 경주시,232,15,217,3,11,3,0,0,66,12,137,0,0,0,1,0,0,0,4,1,9,0,0,3,10,3,0,0,62,11,128,0,0
제18대,9YV1627V,강운태,姜雲太,무소속,광주 남구,179,28,151,1,4,4,0,0,65,17,88,0,0,0,1,2,0,0,11,3,11,0,0,1,3,2,0,0,54,14,77,0,0
제18대,R724713H,김재윤,金才允,통합민주당,제주 서귀포시,1316,70,1246,5,38,18,1,0,361,96,797,0,0,0,3,4,0,0,13,3,47,0,0,5,35,14,1,0,348,93,750,0,0
제18대,34Y32105,임해규,林亥圭,한나라당,경기 부천시원미구갑,338,30,308,3,21,10,1,0,103,21,179,0,0,0,2,0,0,0,13,1,14,0,0,3,19,10,1,0,90,20,165,0,0
제18대,OSM57783,정옥임,鄭玉任,한나라당,비례대표,394,49,345,3,11,5,0,0,93,36,246,0,0,0,0,0,0,0,8,4,37,0,0,3,11,5,0,0,85,32,209,0,0
제18대,TZD17894,원유철,元裕哲,한나라당,경기 평택시갑,364,27,337,4,19,11,0,0,120,33,177,0,0,0,0,0,0,0,7,2,18,0,0,4,19,11,0,0,113,31,159,0,0
제18대,H0G8409H,김충환,金忠環,한나라당,서울 강동구갑,386,40,346,6,18,6,0,0,144,28,184,0,0,3,0,0,0,0,16,3,18,0,0,3,18,6,0,0,128,25,166,0,0
제18대,LXP1076C,김태원,金兌原,한나라당,경기 고양시덕양구을,1067,97,970,14,40,13,0,0,345,96,559,0,0,1,3,0,0,0,36,10,47,0,0,13,37,13,0,0,309,86,512,0,0
제18대,1FK74463,류근찬,柳根粲,자유선진당,충남 보령시서천군,494,21,473,6,18,11,0,0,152,26,281,0,0,0,0,0,0,0,9,2,10,0,0,6,18,11,0,0,143,24,271,0,0
제18대,JVR5259R,이애주,李愛珠,한나라당,비례대표,423,35,388,3,25,6,0,0,138,16,235,0,0,1,1,0,0,0,15,0,18,0,0,2,24,6,0,0,123,16,217,0,0
제18대,C0V2172Q,곽정숙,郭貞淑,민주노동당,비례대표,490,82,408,1,8,7,0,0,145,33,296,0,0,0,0,0,0,0,27,5,50,0,0,1,8,7,0,0,118,28,246,0,0
제18대,99O59850,구본철,具本喆,한나라당,인천 부평구을,329,5,324,15,21,5,0,0,124,30,134,0,0,2,0,0,0,0,0,0,3,0,0,13,21,5,0,0,124,30,131,0,0
제18대,C4T1051R,김성동,金盛東,한나라당,비례대표,194,12,182,2,11,3,0,0,48,9,121,0,0,0,1,0,0,0,3,0,8,0,0,2,10,3,0,0,45,9,113,0,0
제18대,3538970J,김을동,金乙東,친박연대,비례대표,1142,42,1100,130,35,12,0,0,303,171,491,0,0,0,3,2,0,0,4,0,33,0,0,130,32,10,0,0,299,171,458,0,0
제18대,LR83348R,이진삼,李鎭三,자유선진당,"충남 부여군,청양군",490,18,472,2,19,12,0,0,159,42,256,0,0,0,0,5,0,0,3,2,8,0,0,2,19,7,0,0,156,40,248,0,0
제18대,IKQ8876M,김재균,金載均,통합민주당,광주 북구을,904,68,836,7,21,4,0,0,250,53,569,0,0,0,2,0,0,0,19,3,44,0,0,7,19,4,0,0,231,50,525,0,0
제18대,LNR7932L,김진애,金鎭愛,민주당,비례대표,135,11,124,5,2,3,0,0,48,6,71,0,0,0,0,0,0,0,4,1,6,0,0,5,2,3,0,0,44,5,65,0,0
제18대,21U3017N,신낙균,申樂均,통합민주당,,458,36,422,7,10,6,0,0,126,34,275,0,0,0,1,2,0,0,8,3,22,0,0,7,9,4,0,0,118,31,253,0,0
제18대,ACS7139Z,안상수,安商守,한나라당,경기 의왕시과천시,849,37,812,10,44,7,0,0,338,90,360,0,0,0,2,0,0,0,10,6,19,0,0,10,42,7,0,0,328,84,341,0,0
제18대,H6Z15266,김장수,金章洙,한나라당,비례대표,227,5,222,3,17,9,0,0,68,11,119,0,0,0,2,0,0,0,0,0,3,0,0,3,15,9,0,0,68,11,116,0,0
제18대,DTX6052I,김창수,金昌洙,자유선진당,대전 대덕구,720,22,698,12,21,18,0,0,222,47,400,0,0,0,0,0,0,0,6,0,16,0,0,12,21,18,0,0,216,47,384,0,0
제18대,6DG91769,원혜영,元惠榮,통합민주당,경기 부천시오정구,339,23,316,2,11,4,0,0,99,18,205,0,0,0,0,1,0,0,8,1,13,0,0,2,11,3,0,0,91,17,192,0,0
제18대,04H1337G,이명규,李明奎,한나라당,대구 북구갑,493,31,462,12,30,6,0,0,183,35,227,0,0,2,6,0,0,0,10,4,9,0,0,10,24,6,0,0,173,31,218,0,0
제18대,GBP60233,이용삼,李龍三,통합민주당,"강원 철원,화천,양구,인제군",104,3,101,0,6,1,0,0,39,5,53,0,0,0,0,0,0,0,1,0,2,0,0,0,6,1,0,0,38,5,51,0,0
제18대,0WH9705X,전재희,全在姬,한나라당,경기 광명시을,30,6,24,2,2,1,0,0,15,0,10,0,0,1,0,0,0,0,5,0,0,0,0,1,2,1,0,0,10,0,10,0,0
제18대,A523052O,정국교,鄭國敎,통합민주당,비례대표,1,0,1,0,0,0,0,0,0,0,1,0,0,0,0,0,0,0,0,0,0,0,0,0,0,0,0,0,0,0,1,0,0
제18대,DGA8069B,최구식,崔球植,무소속,경남 진주시갑,392,40,352,10,31,3,0,0,140,30,178,0,0,2,1,1,0,0,15,5,16,0,0,8,30,2,0,0,125,25,162,0,0
제18대,4G45218X,심대평,沈大平,자유선진당,충남 공주시연기군,456,12,444,5,19,13,0,0,126,30,263,0,0,0,2,0,0,0,3,0,7,0,0,5,17,13,0,0,123,30,256,0,0
제18대,SVH30067,오제세,吳濟世,통합민주당,충북 청주시흥덕구갑,1369,141,1228,125,28,15,0,0,380,199,622,0,0,0,1,0,0,0,47,12,81,0,0,125,27,15,0,0,333,187,541,0,0
제18대,3SP89633,천정배,千正培,통합민주당,경기 안산시단원구갑,143,6,137,0,0,1,1,0,44,7,90,0,0,0,0,0,0,0,2,0,4,0,0,0,0,1,1,0,42,7,86,0,0
제18대,VBE6017U,홍장표,洪章杓,친박연대,경기 안산시상록구을,225,11,214,9,16,7,0,0,57,30,106,0,0,0,0,1,0,0,2,3,5,0,0,9,16,6,0,0,55,27,101,0,0
제18대,PTC64957,정진섭,鄭鎭燮,한나라당,경기 광주시,620,20,600,127,21,2,0,0,166,153,151,0,0,0,2,0,0,0,4,4,10,0,0,127,19,2,0,0,162,149,141,0,0
제18대,0Y39862U,최철국,崔喆國,통합민주당,경남 김해시을,701,17,684,7,24,8,0,0,229,50,383,0,0,0,1,0,0,0,6,1,9,0,0,7,23,8,0,0,223,49,374,0,0
제18대,DQ92548C,현경병,玄鏡柄,한나라당,서울 노원구갑,298,15,283,10,20,6,0,0,85,27,150,0,0,4,0,0,0,0,2,4,5,0,0,6,20,6,0,0,83,23,145,0,0
제18대,MC32279F,박선숙,朴仙淑,통합민주당,비례대표,576,29,547,3,10,7,0,0,175,34,347,0,0,1,0,0,0,0,11,0,17,0,0,2,10,7,0,0,164,34,330,0,0
제18대,IVT5000L,박종희,朴鍾熙,한나라당,경기 수원시장안구,366,25,341,6,19,7,1,0,135,40,158,0,0,1,2,2,1,0,12,0,7,0,0,5,17,5,0,0,123,40,151,0,0
제18대,Q3X5279D,윤두환,尹斗煥,한나라당,울산 북구,98,16,82,1,6,1,0,0,33,24,33,0,0,0,1,0,0,0,2,8,5,0,0,1,5,1,0,0,31,16,28,0,0
제18대,8TG3670K,이영애,李玲愛,자유선진당,비례대표,0,0,0,0,0,0,0,0,0,0,0,0,0,0,0,0,0,0,0,0,0,0,0,0,0,0,0,0,0,0,0,0,0
제18대,42K7317Y,강승규,姜升圭,한나라당,서울 마포구갑,239,25,214,9,27,5,0,0,69,18,111,0,0,0,4,0,0,0,7,4,10,0,0,9,23,5,0,0,62,14,101,0,0
제18대,MGE7194M,김광림,金光琳,무소속,경북 안동시,244,22,222,6,21,2,0,0,77,26,112,0,0,0,2,0,0,0,13,1,6,0,0,6,19,2,0,0,64,25,106,0,0
제18대,ZYH1940A,이상민,李相珉,자유선진당,대전 유성구,390,68,322,1,6,13,0,0,127,42,201,0,0,1,2,2,0,0,27,8,28,0,0,0,4,11,0,0,100,34,173,0,0
제18대,25G2571T,전현희,全賢姬,통합민주당,비례대표,788,141,647,5,21,14,0,0,172,44,532,0,0,0,1,0,0,0,29,2,109,0,0,5,20,14,0,0,143,42,423,0,0
제18대,EI023764,남경필,南景弼,한나라당,경기 수원시팔달구,235,13,222,5,17,10,0,0,67,20,116,0,0,0,0,0,0,0,1,0,12,0,0,5,17,10,0,0,66,20,104,0,0
제18대,WDR7061Y,이종걸,李鍾杰,통합민주당,경기 안양시만안구,454,46,408,2,3,4,0,0,118,22,305,0,0,0,0,0,0,0,10,2,34,0,0,2,3,4,0,0,108,20,271,0,0
제18대,THS8807E,조진래,趙辰來,한나라당,경남 의령군함안군합천군,911,36,875,126,42,10,0,0,242,158,333,0,0,1,3,0,0,0,13,0,19,0,0,125,39,10,0,0,229,158,314,0,0
제18대,C7Z8238W,황영철,黃永哲,한나라당,"강원 홍천군,횡성군",719,43,676,16,50,7,1,0,240,52,353,0,0,1,9,0,0,0,14,3,16,0,0,15,41,7,1,0,226,49,337,0,0
제18대,H8S93115,강성천,姜成天,한나라당,비례대표,546,33,513,10,36,10,0,0,167,42,281,0,0,1,2,1,0,0,7,4,18,0,0,9,34,9,0,0,160,38,263,0,0
제18대,8IN46764,이주영,李柱榮,한나라당,경남 마산시갑,347,118,229,4,12,3,0,0,118,19,191,0,0,1,4,0,0,0,39,7,67,0,0,3,8,3,0,0,79,12,124,0,0
제18대,HY29614Q,정태근,鄭泰根,한나라당,서울 성북구갑,243,20,223,6,25,4,0,0,76,12,120,0,0,0,1,0,0,0,5,1,13,0,0,6,24,4,0,0,71,11,107,0,0
제18대,T8H6713N,최연희,崔鉛熙,무소속,강원 동해시삼척시,186,7,179,2,7,1,0,0,67,8,101,0,0,0,0,0,0,0,5,1,1,0,0,2,7,1,0,0,62,7,100,0,0
제18대,4Z38561R,이범관,李範觀,한나라당,경기 이천시여주군,97,5,92,3,11,2,0,0,32,9,40,0,0,0,1,0,0,0,3,0,1,0,0,3,10,2,0,0,29,9,39,0,0
제18대,GMK1374L,이석현,李錫玄,통합민주당,경기 안양시동안구갑,378,20,358,1,3,0,0,0,99,14,261,0,0,0,0,0,0,0,3,0,17,0,0,1,3,0,0,0,96,14,244,0,0
제18대,HJI9845B,이인제,李仁濟,무소속,충남 논산시계룡시금산군,102,5,97,1,2,1,0,0,28,8,62,0,0,0,0,1,0,0,1,2,1,0,0,1,2,0,0,0,27,6,61,0,0
제18대,PJ76653N,임태희,任太熙,한나라당,경기 성남시분당구을,130,83,47,0,6,82,0,0,16,9,17,0,0,0,1,79,0,0,2,0,1,0,0,0,5,3,0,0,14,9,16,0,0
제18대,6GI61964,권택기,權宅起,한나라당,서울 광진구갑,300,37,263,9,29,6,1,0,84,28,143,0,0,0,1,0,0,0,8,6,22,0,0,9,28,6,1,0,76,22,121,0,0
제18대,44936542,박종근,朴鍾根,친박연대,대구 달서구갑,178,11,167,3,13,2,0,0,72,15,73,0,0,0,0,0,0,0,4,0,7,0,0,3,13,2,0,0,68,15,66,0,0
제18대,IBT51219,배영식,裵英植,한나라당,"대구 중구,남구",435,22,413,11,17,6,0,0,165,42,194,0,0,0,1,2,0,0,9,2,8,0,0,11,16,4,0,0,156,40,186,0,0
제18대,TST4507I,안규백,安圭伯,통합민주당,비례대표,547,17,530,5,24,12,0,0,160,42,304,0,0,0,1,1,0,0,9,2,4,0,0,5,23,11,0,0,151,40,300,0,0
제18대,54B18425,차명진,車明進,한나라당,경기 부천시소사구,219,18,201,3,14,5,0,0,69,16,112,0,0,1,0,0,0,0,7,1,9,0,0,2,14,5,0,0,62,15,103,0,0
제18대,7GP7701F,박은수,朴殷秀,통합민주당,비례대표,1501,142,1359,11,29,16,1,0,396,81,967,0,0,1,2,2,0,0,28,10,99,0,0,10,27,14,1,0,368,71,868,0,0
제18대,RMC1840P,신성범,愼聖範,한나라당,경남 산청군함양군거창군,731,22,709,15,51,3,0,0,248,46,368,0,0,0,3,0,0,0,6,4,9,0,0,15,48,3,0,0,242,42,359,0,0
제18대,UCD59119,유원일,柳元一,창조한국당,비례대표,484,20,464,1,7,5,0,0,112,29,330,0,0,0,0,1,0,0,2,5,12,0,0,1,7,4,0,0,110,24,318,0,0
제18대,1U115589,장세환,張世煥,통합민주당,전북 전주시완산구을,719,35,684,3,15,8,1,0,219,40,433,0,0,0,0,0,0,0,8,0,27,0,0,3,15,8,1,0,211,40,406,0,0
제18대,6SQ9031K,조전혁,趙全赫,한나라당,인천 남동구을,454,16,438,11,30,12,1,0,137,23,240,0,0,0,0,1,0,0,3,0,12,0,0,11,30,11,1,0,134,23,228,0,0
제18대,6UE9476K,문국현,文國現,창조한국당,서울 은평구을,52,5,47,1,0,0,0,0,15,3,33,0,0,0,0,0,0,0,3,0,2,0,0,1,0,0,0,0,12,3,31,0,0
제18대,GFO6700V,우제창,禹濟昌,통합민주당,경기 용인시처인구,549,14,535,0,20,9,0,0,180,38,302,0,0,0,1,0,0,0,5,1,7,0,0,0,19,9,0,0,175,37,295,0,0
제18대,QM028409,이강래,李康來,통합민주당,전북 남원시순창군,74,10,64,0,2,0,0,0,22,7,43,0,0,0,1,0,0,0,2,0,7,0,0,0,1,0,0,0,20,7,36,0,0
제18대,3RK46312,이정선,李貞善,한나라당,비례대표,683,53,630,10,31,6,0,0,201,55,380,0,0,0,2,0,0,0,21,3,27,0,0,10,29,6,0,0,180,52,353,0,0
제18대,8I61593E,강석호,姜碩鎬,한나라당,"경북 영양,영덕,봉화,울진군",785,19,766,18,52,9,0,0,285,73,348,0,0,0,4,0,0,0,11,1,3,0,0,18,48,9,0,0,274,72,345,0,0
제18대,IRQ5741O,나성린,羅城麟,한나라당,비례대표,570,24,546,14,37,8,1,0,227,40,243,0,0,1,1,0,0,0,14,2,6,0,0,13,36,8,1,0,213,38,237,0,0
제18대,2XI97689,이종구,李鍾九,한나라당,서울 강남구갑,169,15,154,3,9,2,0,0,60,19,76,0,0,1,0,0,0,0,8,0,6,0,0,2,9,2,0,0,52,19,70,0,0
제18대,MPQ32684,최욱철,崔旭澈,무소속,강원 강릉시,61,3,58,1,1,0,0,0,13,6,40,0,0,0,1,0,0,0,0,1,1,0,0,1,0,0,0,0,13,5,39,0,0
제18대,LHG6788P,정범구,鄭範九,민주당,충북 증평군진천군괴산군음성군,207,22,185,2,7,3,0,0,51,9,135,0,0,0,1,0,0,0,9,1,11,0,0,2,6,3,0,0,42,8,124,0,0
제18대,FP15333B,최경희,崔敬禧,한나라당,비례대표,271,14,257,2,9,6,0,0,60,12,182,0,0,0,0,1,0,0,2,0,11,0,0,2,9,5,0,0,58,12,171,0,0
제18대,F5U2979W,김학용,金學容,한나라당,경기 안성시,202,26,176,4,18,3,0,0,62,14,101,0,0,2,8,0,0,0,8,2,6,0,0,2,10,3,0,0,54,12,95,0,0
제18대,TA88758O,백원우,白元宇,통합민주당,경기 시흥시갑,684,36,648,3,15,8,0,0,179,35,444,0,0,0,2,1,0,0,10,1,22,0,0,3,13,7,0,0,169,34,422,0,0
제18대,3D684981,신지호,申志鎬,한나라당,서울 도봉구갑,420,36,384,5,13,6,0,0,140,32,224,0,0,0,0,2,0,0,5,9,20,0,0,5,13,4,0,0,135,23,204,0,0
제18대,7NN1740A,임두성,林斗成,한나라당,비례대표,519,104,415,7,22,6,0,0,189,57,238,0,0,1,1,0,0,0,40,7,55,0,0,6,21,6,0,0,149,50,183,0,0
제18대,QZG38143,김춘진,金椿鎭,통합민주당,전북 고창군부안군,1059,144,915,9,35,14,1,0,300,66,634,0,0,0,3,0,0,0,26,10,105,0,0,9,32,14,1,0,274,56,529,0,0
제18대,BLC8630L,박병석,朴炳錫,통합민주당,대전 서구갑,74,18,56,2,0,1,0,0,18,5,48,0,0,0,0,0,0,0,6,2,10,0,0,2,0,1,0,0,12,3,38,0,0
제18대,NDH62175,이재오,李在五,한나라당,서울 은평구을,13,7,6,0,0,1,0,0,5,0,7,0,0,0,0,0,0,0,2,0,5,0,0,0,0,1,0,0,3,0,2,0,0
제18대,W0E4362P,최영희,崔英姬,통합민주당,비례대표,828,58,770,6,13,12,0,0,238,32,527,0,0,0,0,1,0,0,31,1,25,0,0,6,13,11,0,0,207,31,502,0,0
제18대,2ML68608,강성종,康聖鐘,통합민주당,경기 의정부시을,178,3,175,0,7,0,0,0,55,19,97,0,0,0,0,0,0,0,1,0,2,0,0,0,7,0,0,0,54,19,95,0,0
제18대,GDG1847Z,권성동,權性東,한나라당,강원 강릉시,154,12,142,0,9,2,0,0,42,7,94,0,0,0,1,0,0,0,5,0,6,0,0,0,8,2,0,0,37,7,88,0,0
제18대,DYN10119,김성조,金晟祚,한나라당,경북 구미시갑,395,29,366,8,22,10,0,0,118,43,194,0,0,0,0,1,0,0,9,1,18,0,0,8,22,9,0,0,109,42,176,0,0
제18대,U8D30778,김용구,金容九,자유선진당,비례대표,847,12,835,11,23,17,0,0,266,54,476,0,0,0,1,2,0,0,2,1,6,0,0,11,22,15,0,0,264,53,470,0,0
제18대,Z344466I,박우순,朴宇淳,민주당,강원 원주시,247,12,235,3,6,3,0,0,56,13,166,0,0,0,0,0,0,0,1,0,11,0,0,3,6,3,0,0,55,13,155,0,0
제18대,TVF5566E,백성운,白成雲,한나라당,경기 고양시일산동구,467,32,435,22,25,8,1,0,164,62,185,0,0,2,1,1,0,0,9,9,10,0,0,20,24,7,1,0,155,53,175,0,0
제18대,3EW5478Q,유정현,柳政鉉,한나라당,서울 중랑구갑,680,45,635,10,36,13,2,0,206,43,370,0,0,0,1,1,0,0,20,3,20,0,0,10,35,12,2,0,186,40,350,0,0
제18대,H6577987,이경재,李敬在,무소속,인천 서구강화군을,521,15,506,18,36,8,0,0,194,34,231,0,0,0,1,0,0,0,5,1,8,0,0,18,35,8,0,0,189,33,223,0,0
제18대,OSC50359,강명순,姜命順,한나라당,비례대표,437,32,405,2,23,7,0,0,142,28,235,0,0,0,1,0,0,0,9,1,21,0,0,2,22,7,0,0,133,27,214,0,0
제18대,J1G1329F,김금래,金錦來,한나라당,비례대표,495,36,459,15,31,7,0,0,146,22,274,0,0,2,2,0,0,0,10,3,19,0,0,13,29,7,0,0,136,19,255,0,0
제18대,MHE1145A,박상천,朴相千,통합민주당,"전남 고흥군,보성군",39,5,34,0,4,0,0,0,14,1,20,0,0,0,2,0,0,0,1,0,2,0,0,0,2,0,0,0,13,1,18,0,0
제18대,ILN1240B,박영아,朴英娥,한나라당,서울 송파구갑,173,25,148,3,7,3,0,0,59,5,96,0,0,0,4,0,0,0,5,0,16,0,0,3,3,3,0,0,54,5,80,0,0
제18대,0P85685J,이회창,李會昌,자유선진당,,48,4,44,0,0,1,0,0,14,3,30,0,0,0,0,0,0,0,1,0,3,0,0,0,0,1,0,0,13,3,27,0,0
제18대,NQR1206Q,정진석,鄭鎭碩,한나라당,비례대표,434,94,340,120,14,1,0,0,105,139,55,0,0,43,2,0,0,0,22,18,9,0,0,77,12,1,0,0,83,121,46,0,0
제18대,D8O8176K,조윤선,趙允旋,한나라당,비례대표,241,27,214,4,18,3,1,0,93,18,104,0,0,0,2,0,0,0,12,2,11,0,0,4,16,3,1,0,81,16,93,0,0
제18대,JQA21112,한기호,韓起鎬,한나라당,강원 철원군화천군양구군인제군,134,6,128,0,10,0,0,0,34,8,82,0,0,0,0,0,0,0,1,1,4,0,0,0,10,0,0,0,33,7,78,0,0
제18대,8G72444I,이시종,李始鍾,통합민주당,충북 충주시,411,22,389,4,18,7,0,0,145,37,200,0,0,0,0,2,0,0,9,1,10,0,0,4,18,5,0,0,136,36,190,0,0
제18대,LZW5716C,이춘식,李春植,한나라당,비례대표,340,7,333,6,25,6,0,0,87,27,189,0,0,0,1,0,0,0,0,0,6,0,0,6,24,6,0,0,87,27,183,0,0
제18대,ALY71988,홍정욱,洪政旭,한나라당,서울 노원구병,274,17,257,5,14,4,0,0,79,18,154,0,0,0,0,0,0,0,4,1,12,0,0,5,14,4,0,0,75,17,142,0,0
제18대,XT18076X,박주선,朴柱宣,통합민주당,광주 동구,566,27,539,7,8,4,0,0,161,34,352,0,0,0,0,0,0,0,2,2,23,0,0,7,8,4,0,0,159,32,329,0,0
제18대,ZF959220,안경률,安炅律,한나라당,부산 해운대구기장군을,242,25,217,3,7,5,0,0,77,14,136,0,0,0,0,0,0,0,5,0,20,0,0,3,7,5,0,0,72,14,116,0,0
제18대,D0K32445,이계진,李季振,한나라당,강원 원주시,205,17,188,9,16,2,0,0,74,11,93,0,0,0,3,0,0,0,5,1,8,0,0,9,13,2,0,0,69,10,85,0,0
제18대,EIV1883J,이두아,李枓娥,한나라당,비례대표,266,12,254,4,14,4,0,0,83,17,144,0,0,0,1,0,0,0,4,0,7,0,0,4,13,4,0,0,79,17,137,0,0
제18대,1MB8686B,권경석,權炅錫,한나라당,경남 창원시갑,507,143,364,5,18,6,0,0,166,41,271,0,0,1,2,0,0,0,40,13,87,0,0,4,16,6,0,0,126,28,184,0,0
제18대,XJT56751,박보환,朴普煥,한나라당,경기 화성시을,514,26,488,11,32,8,1,0,183,34,245,0,0,0,1,0,0,0,10,0,15,0,0,11,31,8,1,0,173,34,230,0,0
제18대,DN76694L,이용섭,李庸燮,통합민주당,광주 광산구을,440,34,406,1,12,12,0,0,158,33,224,0,0,0,1,0,0,0,24,2,7,0,0,1,11,12,0,0,134,31,217,0,0
제18대,D7L1937J,이병석,李秉錫,한나라당,경북 포항시북구,134,31,103,5,6,1,0,0,50,19,53,0,0,1,2,0,0,0,9,8,11,0,0,4,4,1,0,0,41,11,42,0,0
제18대,JR141579,정희수,鄭熙秀,한나라당,경북 영천시,621,34,587,8,35,8,0,0,200,77,293,0,0,0,0,0,0,0,7,5,22,0,0,8,35,8,0,0,193,72,271,0,0
제18대,I3B8061W,최문순,崔文洵,통합민주당,비례대표,533,20,513,3,11,3,1,0,165,30,320,0,0,0,0,0,0,0,6,0,14,0,0,3,11,3,1,0,159,30,306,0,0
제18대,KR14136C,홍영표,洪永杓,민주당,인천 부평구을,386,24,362,1,10,4,0,0,99,13,259,0,0,0,0,0,0,0,6,1,17,0,0,1,10,4,0,0,93,12,242,0,0
제18대,0AQ3265T,김동성,金東聖,한나라당,서울 성동구을,253,22,231,3,11,6,0,0,69,29,135,0,0,0,1,1,0,0,4,4,12,0,0,3,10,5,0,0,65,25,123,0,0
제18대,S8431719,박영선,朴映宣,통합민주당,서울 구로구을,520,46,474,8,12,5,0,0,148,19,328,0,0,0,1,0,0,0,5,0,40,0,0,8,11,5,0,0,143,19,288,0,0
제18대,4T21524D,성윤환,成允煥,무소속,경북 상주시,422,36,386,11,34,2,0,0,136,31,208,0,0,1,1,1,0,0,8,0,25,0,0,10,33,1,0,0,128,31,183,0,0
제18대,7XM9484U,신영수,申榮洙,한나라당,경기 성남시수정구,529,36,493,9,26,8,0,0,165,55,266,0,0,0,1,0,0,0,18,2,15,0,0,9,25,8,0,0,147,53,251,0,0
제18대,5KI6669W,김노식,金魯植,친박연대,,14,0,14,1,0,0,0,0,3,2,8,0,0,0,0,0,0,0,0,0,0,0,0,1,0,0,0,0,3,2,8,0,0
제18대,RSE18860,김옥이,金玉伊,한나라당,비례대표,492,20,472,5,35,9,0,0,140,32,271,0,0,1,0,0,0,0,4,1,14,0,0,4,35,9,0,0,136,31,257,0,0
제18대,YKA9050K,홍재형,洪在馨,통합민주당,충북 청주시상당구,458,46,412,5,10,8,0,0,151,23,261,0,0,0,0,0,0,0,12,2,32,0,0,5,10,8,0,0,139,21,229,0,0
제18대,PAO22428,송영길,宋永吉,통합민주당,인천 계양구을,472,19,453,4,12,10,0,0,157,40,249,0,0,0,0,1,0,0,8,4,6,0,0,4,12,9,0,0,149,36,243,0,0
제18대,TIS61927,양승조,梁承晁,통합민주당,충남 천안시갑,1741,119,1622,9,36,16,1,0,488,99,1092,0,0,0,1,2,0,0,24,2,90,0,0,9,35,14,1,0,464,97,1002,0,0
제18대,P303213F,정병국,鄭柄國,한나라당,경기 양평군가평군,394,21,373,6,31,6,0,0,142,33,176,0,0,0,1,0,0,0,11,3,6,0,0,6,30,6,0,0,131,30,170,0,0
제18대,FJ03481D,최경환,崔炅煥,한나라당,경북 경산시청도군,109,16,93,2,13,0,1,0,46,9,38,0,0,0,0,0,0,0,11,0,5,0,0,2,13,0,1,0,35,9,33,0,0
제18대,SAA7309Q,이한성,李翰成,한나라당,경북 문경시예천군,2265,43,2222,27,99,23,1,0,696,199,1220,0,0,1,3,1,1,0,10,0,27,0,0,26,96,22,0,0,686,199,1193,0,0
제18대,3TF1550T,권영길,權永吉,민주노동당,경남 창원시을,538,31,507,1,6,7,0,0,144,23,357,0,0,0,0,1,0,0,9,1,20,0,0,1,6,6,0,0,135,22,337,0,0
제18대,UIZ3103R,김부겸,金富謙,통합민주당,경기 군포시,378,13,365,3,12,5,0,0,101,20,237,0,0,0,0,1,0,0,3,0,9,0,0,3,12,4,0,0,98,20,228,0,0
제18대,UY23844S,김일윤,金一潤,무소속,경북 경주시,22,0,22,0,0,1,0,0,11,4,6,0,0,0,0,0,0,0,0,0,0,0,0,0,0,1,0,0,11,4,6,0,0
제18대,P318485D,박민식,朴敏植,한나라당,부산 북구강서구갑,559,81,478,10,37,5,2,0,188,49,268,0,0,6,6,0,0,0,25,6,38,0,0,4,31,5,2,0,163,43,230,0,0
제18대,MSY7784L,윤상현,尹相現,한나라당,인천 남구을,266,19,247,6,16,5,0,0,91,19,129,0,0,0,1,1,0,0,4,2,11,0,0,6,15,4,0,0,87,17,118,0,0
제18대,BW19186J,홍사덕,洪思德,친박연대,대구 서구,286,5,281,4,17,2,0,0,89,11,163,0,0,0,1,0,0,0,2,0,2,0,0,4,16,2,0,0,87,11,161,0,0
제18대,7PU7009N,강봉균,康奉均,통합민주당,전북 군산시,140,12,128,3,8,0,0,0,55,9,65,0,0,1,0,0,0,0,7,0,4,0,0,2,8,0,0,0,48,9,61,0,0
제18대,WYI5610U,김혜성,金惠聖,친박연대,비례대표,273,33,240,4,11,4,0,0,73,13,168,0,0,1,0,1,0,0,12,1,18,0,0,3,11,3,0,0,61,12,150,0,0
제18대,A1M4510O,송민순,宋旻淳,통합민주당,비례대표,750,23,727,4,20,14,0,0,234,61,417,0,0,0,1,1,0,0,5,2,14,0,0,4,19,13,0,0,229,59,403,0,0
제18대,0XK21509,안효대,安孝大,한나라당,울산 동구,750,56,694,16,40,8,0,0,247,64,375,0,0,2,2,3,0,0,21,4,24,0,0,14,38,5,0,0,226,60,351,0,0
제18대,L726240M,안형환,安亨奐,한나라당,서울 금천구,274,8,266,10,23,2,0,0,100,16,123,0,0,0,1,0,0,0,2,1,4,0,0,10,22,2,0,0,98,15,119,0,0
제18대,DMR40160,유일호,柳一鎬,한나라당,서울 송파구을,261,23,238,4,15,3,0,0,91,11,137,0,0,0,0,0,0,0,7,0,16,0,0,4,15,3,0,0,84,11,121,0,0
제18대,XGQ9659R,이한구,李漢久,한나라당,대구 수성구갑,116,20,96,2,10,1,0,0,44,9,50,0,0,0,1,0,0,0,6,3,10,0,0,2,9,1,0,0,38,6,40,0,0
제18대,IN328264,조정식,趙正湜,통합민주당,경기 시흥시을,597,37,560,7,15,4,0,0,162,30,379,0,0,3,1,0,0,0,18,1,14,0,0,4,14,4,0,0,144,29,365,0,0
제18대,FSN5613H,박희태,朴熺太,한나라당,경남 양산시,19,2,17,0,2,0,0,0,2,2,13,0,0,0,1,0,0,0,0,0,1,0,0,0,1,0,0,0,2,2,12,0,0
제18대,FND7010Q,손학규,孫鶴圭,민주당,경기 성남시분당구을,6,1,5,0,0,0,0,0,3,0,3,0,0,0,0,0,0,0,1,0,0,0,0,0,0,0,0,0,2,0,3,0,0
제18대,AQZ80083,송훈석,宋勳錫,무소속,강원 속초시고성군양양군,464,43,421,19,20,6,0,0,128,33,258,0,0,0,1,1,0,0,14,0,27,0,0,19,19,5,0,0,114,33,231,0,0
제18대,8QG6926L,신건,辛建,무소속,전북 전주시완산구갑,331,1,330,4,10,8,0,0,78,10,221,0,0,0,0,0,0,0,0,0,1,0,0,4,10,8,0,0,78,10,220,0,0
제18대,PMU9608V,김태환,金泰煥,무소속,경북 구미시을,322,10,312,4,29,6,0,0,107,21,155,0,0,0,4,0,0,0,2,1,3,0,0,4,25,6,0,0,105,20,152,0,0
제18대,W1W1462T,박준선,朴俊宣,한나라당,경기 용인시기흥구,1107,46,1061,139,46,10,0,0,306,197,409,0,0,1,2,1,0,0,14,4,24,0,0,138,44,9,0,0,292,193,385,0,0
제18대,BJW1335W,변웅전,邊雄田,자유선진당,"충남 서산시,태안군",297,27,270,2,8,9,0,0,84,20,174,0,0,0,1,1,0,0,6,1,18,0,0,2,7,8,0,0,78,19,156,0,0
제18대,GKV4796M,정장선,鄭長善,통합민주당,경기 평택시을,345,19,326,4,9,2,0,0,92,22,216,0,0,0,0,0,0,0,4,3,12,0,0,4,9,2,0,0,88,19,204,0,0
제18대,5JA4781U,김영록,金瑛錄,무소속,"전남 해남,완도,진도군",753,54,699,14,33,11,0,0,215,53,427,0,0,0,1,2,0,0,17,7,27,0,0,14,32,9,0,0,198,46,400,0,0
제18대,1C04271Z,김영환,金榮煥,민주당,경기 안산시상록구을,78,9,69,1,4,0,0,0,27,2,44,0,0,0,0,0,0,0,4,0,5,0,0,1,4,0,0,0,23,2,39,0,0
제18대,CZN3813Q,김정,金情,친박연대,비례대표,226,24,202,3,10,3,0,0,58,11,141,0,0,0,1,0,0,0,5,2,16,0,0,3,9,3,0,0,53,9,125,0,0
제18대,64G6894C,김정훈,金正薰,한나라당,부산 남구갑,412,32,380,11,25,5,0,0,133,38,200,0,0,0,2,0,0,0,7,2,21,0,0,11,23,5,0,0,126,36,179,0,0
제18대,SCA7983X,최종원,崔鍾元,민주당,강원 태백시영월군평창군정선군,197,8,189,2,6,1,0,0,34,11,143,0,0,0,0,0,0,0,3,2,3,0,0,2,6,1,0,0,31,9,140,0,0
제18대,EBU8493R,이미경,李美卿,통합민주당,서울 은평구갑,673,18,655,1,12,12,0,0,187,36,425,0,0,0,0,1,0,0,7,0,10,0,0,1,12,11,0,0,180,36,415,0,0
제18대,BWD92364,이찬열,李燦烈,민주당,경기 수원시장안구,467,21,446,3,12,5,0,0,109,38,300,0,0,0,0,0,0,0,3,2,16,0,0,3,12,5,0,0,106,36,284,0,0
제18대,V1849655,정의화,鄭義和,한나라당,부산 중구동구,391,26,365,8,27,8,0,0,113,23,212,0,0,1,0,0,0,0,7,0,18,0,0,7,27,8,0,0,106,23,194,0,0
제18대,8SV6917G,주호영,朱豪英,한나라당,대구 수성구을,219,88,131,4,14,84,0,0,29,17,71,0,0,1,2,81,0,0,2,0,2,0,0,3,12,3,0,0,27,17,69,0,0
제18대,SSH8397C,김낙성,金洛聖,자유선진당,충남 당진군,582,23,559,8,21,12,0,0,172,37,332,0,0,0,1,0,0,0,5,4,13,0,0,8,20,12,0,0,167,33,319,0,0
제18대,JOM36883,김소남,金小南,한나라당,비례대표,1125,94,1031,13,48,17,0,0,316,77,654,0,0,0,0,0,0,0,27,5,62,0,0,13,48,17,0,0,289,72,592,0,0
제18대,K3672835,문학진,文學振,통합민주당,경기 하남시,612,14,598,6,11,4,0,0,196,47,348,0,0,0,0,0,0,0,1,2,11,0,0,6,11,4,0,0,195,45,337,0,0
제18대,S0S7941O,박대해,朴大海,친박연대,부산 연제구,597,32,565,8,20,8,0,0,185,38,338,0,0,0,0,1,0,0,14,2,15,0,0,8,20,7,0,0,171,36,323,0,0
제18대,BCO6264C,김영진,金泳鎭,통합민주당,광주 서구을,1252,42,1210,7,28,10,1,0,363,86,757,0,0,0,0,1,0,0,15,0,26,0,0,7,28,9,1,0,348,86,731,0,0
제18대,AMF4093D,김용태,金容兌,한나라당,서울 양천구을,596,15,581,124,25,9,1,0,151,155,131,0,0,0,2,1,0,0,4,2,6,0,0,124,23,8,1,0,147,153,125,0,0
제18대,4Y54669I,서청원,徐淸源,친박연대,비례대표,90,5,85,1,3,1,0,0,31,11,43,0,0,0,0,0,0,0,2,1,2,0,0,1,3,1,0,0,29,10,41,0,0
제18대,1EL35837,원희룡,元喜龍,한나라당,서울 양천구갑,406,3,403,6,29,7,0,0,148,37,179,0,0,0,2,0,0,0,1,0,0,0,0,6,27,7,0,0,147,37,179,0,0
제18대,TOU1222X,강창일,姜昌一,통합민주당,제주 제주시갑,1575,197,1378,10,39,11,0,0,436,112,967,0,0,2,3,1,0,0,51,13,127,0,0,8,36,10,0,0,385,99,840,0,0
제18대,99J1216Q,공성진,孔星鎭,한나라당,서울 강남구을,194,22,172,6,19,6,0,0,46,21,96,0,0,0,1,2,0,0,4,3,12,0,0,6,18,4,0,0,42,18,84,0,0
제18대,LYY5513O,권영진,權泳臻,한나라당,서울 노원구을,988,50,938,12,47,9,1,0,332,71,516,0,0,4,2,1,0,0,14,2,27,0,0,8,45,8,1,0,318,69,489,0,0
제18대,M7I8728R,김성수,金性洙,한나라당,"경기 양주시,동두천시",1199,36,1163,16,59,13,1,0,386,99,625,0,0,0,2,1,0,0,10,1,22,0,0,16,57,12,1,0,376,98,603,0,0
제18대,JUM9212Y,장광근,張光根,한나라당,,269,26,243,10,20,5,0,0,99,34,101,0,0,2,2,0,0,0,7,4,11,0,0,8,18,5,0,0,92,30,90,0,0
제18대,V8I36226,장병완,張秉浣,민주통합당,광주 남구,318,45,273,1,5,5,0,0,58,13,236,0,0,1,1,0,0,0,3,2,38,0,0,0,4,5,0,0,55,11,198,0,0
제18대,AFM9947E,김종률,金鍾律,통합민주당,"충북 증평,진천,괴산,음성군",775,103,672,119,18,6,0,0,244,173,215,0,0,36,0,0,0,0,27,29,11,0,0,83,18,6,0,0,217,144,204,0,0
제18대,LJJ52334,송광호,宋光浩,한나라당,충북 제천시단양군,201,20,181,6,17,3,1,0,65,22,87,0,0,0,2,0,0,0,5,1,12,0,0,6,15,3,1,0,60,21,75,0,0
제18대,GW154990,윤상일,尹相逸,친박연대,비례대표,170,10,160,2,4,1,0,0,41,8,114,0,0,0,0,0,0,0,3,0,7,0,0,2,4,1,0,0,38,8,107,0,0
제18대,QUM8288K,이달곤,李達坤,한나라당,비례대표,164,44,120,8,17,4,0,0,67,7,61,0,0,2,2,0,0,0,23,2,15,0,0,6,15,4,0,0,44,5,46,0,0
제18대,PLR62452,김영우,金榮宇,한나라당,경기 포천시연천군,335,20,315,12,22,6,0,0,97,32,166,0,0,0,0,0,0,0,7,1,12,0,0,12,22,6,0,0,90,31,154,0,0
제18대,UIN2835Q,김효석,金孝錫,통합민주당,전남 담양군곡성군구례군,705,44,661,9,18,2,0,0,225,44,407,0,0,1,2,0,0,0,20,5,16,0,0,8,16,2,0,0,205,39,391,0,0
제18대,CYD5815E,정갑윤,鄭甲潤,한나라당,울산 중구,757,32,725,24,44,16,2,0,249,59,363,0,0,0,3,1,0,0,8,1,19,0,0,24,41,15,2,0,241,58,344,0,0
제18대,37K34903,홍희덕,洪熙德,민주노동당,비례대표,862,20,842,119,10,8,0,0,229,155,341,0,0,0,0,0,0,0,4,0,16,0,0,119,10,8,0,0,225,155,325,0,0
제18대,SKV1971K,유선호,柳宣浩,통합민주당,전남 장흥군강진군영암군,777,47,730,7,18,13,0,0,173,58,508,0,0,0,1,1,0,0,11,6,28,0,0,7,17,12,0,0,162,52,480,0,0
제18대,ZB494869,정영희,丁英姬,친박연대,비례대표,643,18,625,5,30,9,0,0,220,55,324,0,0,1,1,0,0,0,3,1,12,0,0,4,29,9,0,0,217,54,312,0,0
제18대,06L2365K,홍일표,洪日杓,한나라당,인천 남구갑,361,22,339,7,15,6,0,0,136,27,170,0,0,1,1,0,0,0,7,1,12,0,0,6,14,6,0,0,129,26,158,0,0
제18대,SOB8871D,권선택,權善宅,자유선진당,대전 중구,597,24,573,9,20,18,0,0,178,34,338,0,0,0,0,1,0,0,4,2,17,0,0,9,20,17,0,0,174,32,321,0,0
제18대,UGH6481E,김상희,金相姬,통합민주당,비례대표,660,55,605,6,21,9,0,0,220,28,376,0,0,1,2,0,0,0,14,3,35,0,0,5,19,9,0,0,206,25,341,0,0
제18대,BEJ7022K,김성회,金成會,한나라당,경기 화성시갑,374,16,358,3,26,5,0,0,130,36,174,0,0,0,0,0,0,0,5,2,9,0,0,3,26,5,0,0,125,34,165,0,0
제18대,CAL85655,유기준,兪奇濬,무소속,부산 서구,770,26,744,14,35,9,0,0,268,75,369,0,0,0,1,0,0,0,3,4,18,0,0,14,34,9,0,0,265,71,351,0,0
제18대,X7I4680R,김기현,金起炫,한나라당,울산 남구을,246,35,211,4,14,5,0,0,103,17,103,0,0,2,2,2,0,0,21,1,7,0,0,2,12,3,0,0,82,16,96,0,0
제18대,DTG4846A,김선동,金善東,한나라당,서울 도봉구을,0,0,0,0,0,0,0,0,0,0,0,0,0,0,0,0,0,0,0,0,0,0,0,0,0,0,0,0,0,0,0,0,0
제18대,NFR83567,김세웅,金世雄,통합민주당,전북 전주시덕진구,59,4,55,0,5,0,0,0,16,4,34,0,0,0,0,0,0,0,2,2,0,0,0,0,5,0,0,0,14,2,34,0,0
제18대,6YT83269,이명수,李明洙,자유선진당,충남 아산시,1614,355,1259,131,34,25,2,0,453,218,751,0,0,39,6,4,0,0,102,41,163,0,0,92,28,21,2,0,351,177,588,0,0
제18대,NET6850O,이윤성,李允盛,한나라당,인천 남동구갑,307,23,284,10,18,3,0,0,101,13,162,0,0,3,1,0,0,0,7,0,12,0,0,7,17,3,0,0,94,13,150,0,0
제18대,0ID22746,이진복,李珍福,무소속,부산 동래구,419,30,389,13,33,10,1,0,125,28,209,0,0,0,0,0,0,0,9,3,18,0,0,13,33,10,1,0,116,25,191,0,0
제18대,BQS2021C,김성태,金聖泰,한나라당,서울 강서구을,911,31,880,18,50,7,0,0,303,93,440,0,0,0,2,0,0,0,12,1,16,0,0,18,48,7,0,0,291,92,424,0,0
제18대,X316937B,김정권,金正權,한나라당,경남 김해시갑,1093,39,1054,14,48,11,0,0,360,103,557,0,0,1,0,1,0,0,15,4,18,0,0,13,48,10,0,0,345,99,539,0,0
제18대,RG97851G,선경식,宣炅植,창조한국당,비례대표,1,0,1,0,0,0,0,0,0,0,1,0,0,0,0,0,0,0,0,0,0,0,0,0,0,0,0,0,0,0,1,0,0
제18대,0767470D,이낙연,李洛淵,통합민주당,전남 함평군영광군장성군,565,39,526,5,26,3,0,0,133,40,358,0,0,0,1,0,0,0,13,2,23,0,0,5,25,3,0,0,120,38,335,0,0
제18대,4D93608C,원희목,元喜睦,한나라당,비례대표,1102,50,1052,125,43,17,0,0,274,175,468,0,0,0,3,1,0,0,19,0,27,0,0,125,40,16,0,0,255,175,441,0,0
제18대,CZB4125D,장제원,張濟元,한나라당,부산 사상구,455,57,398,10,19,9,0,0,143,38,236,0,0,1,1,2,0,0,17,7,29,0,0,9,18,7,0,0,126,31,207,0,0
제18대,0GX8381G,정해걸,丁海杰,무소속,"경북 군위군,의성군,청송군",1124,35,1089,31,77,10,2,0,312,81,611,0,0,0,7,0,0,0,17,0,11,0,0,31,70,10,2,0,295,81,600,0,0
제18대,GCA42857,주승용,朱昇鎔,통합민주당,전남 여수시을,926,79,847,7,30,8,0,0,234,41,606,0,0,0,1,0,0,0,26,1,51,0,0,7,29,8,0,0,208,40,555,0,0
제18대,1PK82111,강기정,姜琪正,통합민주당,광주 북구갑,980,44,936,9,17,7,1,0,261,76,609,0,0,0,0,0,0,0,4,2,38,0,0,9,17,7,1,0,257,74,571,0,0
제18대,4NU4867S,구상찬,具相燦,한나라당,서울 강서구갑,299,11,288,9,16,3,0,0,91,19,161,0,0,0,0,0,0,0,4,2,5,0,0,9,16,3,0,0,87,17,156,0,0
제18대,CRW93712,김학재,金鶴在,민주당,비례대표,50,5,45,0,1,1,0,0,11,1,36,0,0,0,0,0,0,0,3,0,2,0,0,0,1,1,0,0,8,1,34,0,0
제18대,71M8132V,신상진,申相珍,한나라당,경기 성남시중원구,780,75,705,11,33,11,0,0,263,71,391,0,0,0,2,2,0,0,39,12,20,0,0,11,31,9,0,0,224,59,371,0,0
제18대,LCJ77278,이혜훈,李惠薰,한나라당,서울 서초구갑,261,77,184,9,15,1,0,0,92,32,112,0,0,2,5,0,0,0,27,10,33,0,0,7,10,1,0,0,65,22,79,0,0
제18대,DCN7433W,정세균,丁世均,통합민주당,"전북 진안,무주,장수군,임실군",75,1,74,0,5,0,0,0,30,7,33,0,0,0,0,0,0,0,0,0,1,0,0,0,5,0,0,0,30,7,32,0,0
제18대,VE469451,최재성,崔宰誠,통합민주당,경기 남양주시갑,429,31,398,0,8,4,1,0,122,31,263,0,0,0,1,1,0,0,5,3,21,0,0,0,7,3,1,0,117,28,242,0,0
제18대,IU54544T,고승덕,高承德,한나라당,서울 서초구을,684,41,643,14,41,12,1,0,219,65,332,0,0,2,2,1,0,0,11,5,20,0,0,12,39,11,1,0,208,60,312,0,0
제18대,LG63087O,권영세,權寧世,한나라당,서울 영등포구을,213,16,197,4,10,2,0,0,88,10,99,0,0,0,0,0,0,0,9,1,6,0,0,4,10,2,0,0,79,9,93,0,0
제18대,QG36879J,이사철,李思哲,한나라당,경기 부천시원미구을,439,17,422,10,32,7,2,0,122,32,234,0,0,0,1,1,0,0,5,1,9,0,0,10,31,6,2,0,117,31,225,0,0
제18대,6MT5042E,이인기,李仁基,무소속,경북 고령군성주군칠곡군,1048,49,999,17,57,17,1,0,361,87,508,0,0,0,2,3,0,0,20,4,20,0,0,17,55,14,1,0,341,83,488,0,0
제18대,ZC87486D,김선동,金先東,민주노동당,전남 순천시,0,0,0,0,0,0,0,0,0,0,0,0,0,0,0,0,0,0,0,0,0,0,0,0,0,0,0,0,0,0,0,0,0
제18대,INO4490Y,손숙미,孫淑美,한나라당,비례대표,763,93,670,5,35,19,0,0,199,52,453,0,0,0,6,9,0,0,23,2,53,0,0,5,29,10,0,0,176,50,400,0,0
제18대,PWU27609,유승민,劉承旼,한나라당,대구 동구을,397,7,390,5,24,4,0,0,145,37,182,0,0,0,1,0,0,0,2,1,3,0,0,5,23,4,0,0,143,36,179,0,0
제18대,DDK4008U,이재선,李在善,자유선진당,대전 서구을,464,29,435,6,11,7,0,0,153,35,252,0,0,0,0,1,0,0,13,0,15,0,0,6,11,6,0,0,140,35,237,0,0
제18대,IDV9108J,진영,陳永,한나라당,서울 용산구,196,17,179,3,11,1,0,0,65,13,103,0,0,0,2,0,0,0,6,3,6,0,0,3,9,1,0,0,59,10,97,0,0
제18대,URV1689Q,추미애,秋美愛,통합민주당,서울 광진구을,265,27,238,2,5,5,0,0,78,7,168,0,0,0,1,0,0,0,5,0,21,0,0,2,4,5,0,0,73,7,147,0,0
제18대,DCR84445,김동철,金東喆,통합민주당,광주 광산구갑,783,62,721,5,15,6,0,0,231,54,472,0,0,0,0,0,0,0,28,4,30,0,0,5,15,6,0,0,203,50,442,0,0
제18대,CKH5381Y,노철래,盧喆來,친박연대,비례대표,504,21,483,5,20,6,0,0,137,36,300,0,0,0,0,0,0,0,6,2,13,0,0,5,20,6,0,0,131,34,287,0,0
제18대,I7Z3068X,유성엽,柳成葉,무소속,전북 정읍시,2016,59,1957,18,73,22,0,0,634,151,1118,0,0,0,3,2,0,0,13,0,41,0,0,18,70,20,0,0,621,151,1077,0,0
제18대,SEK1881Q,유재중,柳在仲,무소속,부산 수영구,647,38,609,16,36,10,1,0,196,41,347,0,0,0,1,0,0,0,9,3,25,0,0,16,35,10,1,0,187,38,322,0,0
제18대,PHE6239O,송영선,宋永仙,친박연대,비례대표,399,29,370,6,16,10,0,0,131,25,211,0,0,0,3,2,0,0,2,1,21,0,0,6,13,8,0,0,129,24,190,0,0
제18대,NBF6548X,조승수,趙承洙,진보신당,울산 북구,354,34,320,0,7,6,0,0,86,14,241,0,0,0,0,1,0,0,6,1,26,0,0,0,7,5,0,0,80,13,215,0,0
제18대,EWR39555,주성영,朱盛英,한나라당,대구 동구갑,227,22,205,3,16,0,2,0,82,18,106,0,0,0,0,0,0,0,4,5,13,0,0,3,16,0,2,0,78,13,93,0,0
제18대,RE32613N,조순형,趙舜衡,자유선진당,비례대표,18,0,18,1,2,0,0,0,4,0,11,0,0,0,0,0,0,0,0,0,0,0,0,1,2,0,0,0,4,0,11,0,0
제18대,IYD4143Y,문희상,文喜相,통합민주당,경기 의정부시갑,99,6,93,0,2,1,0,0,34,9,53,0,0,0,0,0,0,0,1,2,3,0,0,0,2,1,0,0,33,7,50,0,0
제18대,8BF5855P,박지원,朴智元,무소속,전남 목포시,246,17,229,4,7,4,0,0,63,7,161,0,0,2,0,1,0,0,2,0,12,0,0,2,7,3,0,0,61,7,149,0,0
제18대,QT984813,신학용,辛鶴用,통합민주당,인천 계양구갑,585,36,549,4,17,4,0,0,189,42,329,0,0,1,0,0,0,0,13,3,19,0,0,3,17,4,0,0,176,39,310,0,0
제18대,0667420L,이윤석,李潤錫,무소속,"전남 무안군,신안군",649,23,626,6,27,11,0,0,212,51,342,0,0,0,1,0,0,0,9,1,12,0,0,6,26,11,0,0,203,50,330,0,0
제18대,P2G3854D,강용석,康容碩,한나라당,서울 마포구을,263,4,259,3,13,4,0,0,63,25,155,0,0,1,0,0,0,0,0,0,3,0,0,2,13,4,0,0,63,25,152,0,0
제18대,2WQ6656P,김세연,金世淵,무소속,부산 금정구,763,37,726,11,35,9,0,0,235,48,425,0,0,2,0,0,0,0,8,2,25,0,0,9,35,9,0,0,227,46,400,0,0
제18대,BGF3673X,김희철,金熙喆,통합민주당,서울 관악구을,390,36,354,1,13,4,0,0,143,38,191,0,0,0,0,1,0,0,8,9,18,0,0,1,13,3,0,0,135,29,173,0,0
제18대,AFQ26679,주광덕,朱光德,한나라당,경기 구리시,765,32,733,128,25,5,2,0,210,162,233,0,0,0,0,0,0,0,7,5,20,0,0,128,25,5,2,0,203,157,213,0,0
제18대,9DF85543,허범도,許範道,한나라당,경남 양산시,139,6,133,9,11,6,0,0,56,14,43,0,0,0,1,0,0,0,3,1,1,0,0,9,10,6,0,0,53,13,42,0,0
제18대,QNI3781H,김유정,金裕貞,통합민주당,비례대표,303,23,280,3,9,5,0,0,95,18,173,0,0,0,0,1,0,0,8,0,14,0,0,3,9,4,0,0,87,18,159,0,0
제18대,CT85313K,서병수,徐秉洙,한나라당,부산 해운대구기장군갑,204,47,157,6,15,2,1,0,72,16,92,0,0,2,1,0,0,0,19,5,20,0,0,4,14,2,1,0,53,11,72,0,0
제18대,WMY7084J,이무영,李茂永,무소속,전북 전주시완산구갑,28,1,27,0,3,1,0,0,10,2,12,0,0,0,0,0,0,0,1,0,0,0,0,0,3,1,0,0,9,2,12,0,0
제18대,EIV1009T,정두언,鄭斗彦,한나라당,서울 서대문구을,354,23,331,5,28,6,0,0,106,29,180,0,0,0,2,1,0,0,7,3,10,0,0,5,26,5,0,0,99,26,170,0,0
제18대,53Y1887H,최규성,崔圭成,통합민주당,전북 김제시완주군,826,56,770,13,18,10,0,0,232,75,478,0,0,0,1,0,0,0,24,11,20,0,0,13,17,10,0,0,208,64,458,0,0
제18대,L3X8851C,최인기,崔仁基,통합민주당,전남 나주시화순군,530,30,500,8,19,1,0,0,173,35,294,0,0,0,1,1,0,0,16,2,10,0,0,8,18,0,0,0,157,33,284,0,0
제18대,2QE48823,장윤석,張倫碩,한나라당,경북 영주시,236,22,214,5,19,3,2,0,70,16,121,0,0,0,4,0,2,0,6,0,10,0,0,5,15,3,0,0,64,16,111,0,0
제18대,N9X9673B,전혜숙,全惠淑,통합민주당,비례대표,565,34,531,7,19,5,0,0,196,33,305,0,0,0,2,0,0,0,16,2,14,0,0,7,17,5,0,0,180,31,291,0,0
제18대,5KV82250,조경태,趙慶泰,통합민주당,부산 사하구을,581,75,506,3,13,1,0,0,150,44,370,0,0,0,1,0,0,0,15,2,57,0,0,3,12,1,0,0,135,42,313,0,0
제18대,1G96387U,조진형,趙鎭衡,한나라당,인천 부평구갑,203,21,182,4,9,2,0,0,62,12,114,0,0,0,0,0,0,0,6,1,14,0,0,4,9,2,0,0,56,11,100,0,0
제18대,XQ98168F,강길부,姜吉夫,무소속,울산 울주군,346,16,330,5,19,8,0,0,126,21,167,0,0,0,0,0,0,0,9,1,6,0,0,5,19,8,0,0,117,20,161,0,0
제18대,P0F1530P,김태호,金台鎬,한나라당,경남 김해시을,54,2,52,0,2,2,0,0,6,1,43,0,0,0,0,1,0,0,0,0,1,0,0,0,2,1,0,0,6,1,42,0,0
제18대,V8Y41572,서갑원,徐甲源,통합민주당,전남 순천시,265,19,246,2,7,3,0,0,69,17,167,0,0,0,0,0,0,0,4,2,13,0,0,2,7,3,0,0,65,15,154,0,0
제18대,0135473I,이군현,李君賢,한나라당,경남 통영시고성군,169,16,153,1,9,5,0,0,42,10,102,0,0,0,0,0,0,0,6,0,10,0,0,1,9,5,0,0,36,10,92,0,0
제18대,X1E79772,양정례,梁貞禮,친박연대,비례대표,380,7,373,5,16,5,0,0,146,47,161,0,0,0,0,0,0,0,2,1,4,0,0,5,16,5,0,0,144,46,157,0,0
제18대,Z6R3959C,조해진,曺海珍,한나라당,경남 밀양시창녕군,139,16,123,1,11,4,0,0,37,12,74,0,0,0,3,1,0,0,0,0,12,0,0,1,8,3,0,0,37,12,62,0,0
제18대,Q9H5708M,김진표,金振杓,통합민주당,경기 수원시영통구,301,25,276,3,10,1,0,0,83,24,180,0,0,0,1,0,0,0,6,3,15,0,0,3,9,1,0,0,77,21,165,0,0
제18대,RVD1966C,이해봉,李海鳳,무소속,대구 달서구을,829,9,820,13,31,10,0,0,286,83,406,0,0,1,0,0,0,0,4,1,3,0,0,12,31,10,0,0,282,82,403,0,0
제18대,M8X1458S,허원제,許元齊,한나라당,부산 부산진구갑,392,31,361,9,26,5,0,0,134,13,205,0,0,1,3,0,0,0,8,1,18,0,0,8,23,5,0,0,126,12,187,0,0
제18대,Q5X4506F,황우여,黃祐呂,한나라당,인천 연수구,577,18,559,4,19,6,0,0,202,31,315,0,0,0,1,0,0,0,8,0,9,0,0,4,18,6,0,0,194,31,306,0,0
제18대,4MX3134T,김형오,金炯旿,한나라당,부산 영도구,24,3,21,1,1,0,0,0,6,0,16,0,0,0,0,0,0,0,0,0,3,0,0,1,1,0,0,0,6,0,13,0,0
제18대,S312791R,윤석용,尹碩鎔,한나라당,서울 강동구을,803,90,713,8,41,7,0,0,236,58,453,0,0,0,3,1,0,0,22,3,61,0,0,8,38,6,0,0,214,55,392,0,0
제18대,L3P9125A,이화수,李和洙,한나라당,경기 안산시상록구갑,748,37,711,20,41,8,0,0,229,56,394,0,0,4,3,0,0,0,7,3,20,0,0,16,38,8,0,0,222,53,374,0,0
제18대,IWK63872,조배숙,趙培淑,통합민주당,전북 익산시을,545,42,503,2,18,5,0,0,135,37,348,0,0,0,2,1,0,0,14,2,23,0,0,2,16,4,0,0,121,35,325,0,0
제18대,VNF2868Z,조원진,趙源震,친박연대,대구 달서구병,407,34,373,7,30,7,0,0,128,29,206,0,0,2,1,1,0,0,13,1,16,0,0,5,29,6,0,0,115,28,190,0,0
제18대,RUW8681N,황진하,黃震夏,한나라당,경기 파주시,217,20,197,2,15,5,0,0,57,23,115,0,0,0,1,1,0,0,6,2,10,0,0,2,14,4,0,0,51,21,105,0,0
제18대,SLW27496,나경원,羅景垣,한나라당,서울 중구,235,21,214,12,22,2,0,0,71,20,108,0,0,0,1,0,0,0,9,3,8,0,0,12,21,2,0,0,62,17,100,0,0
제18대,RLG4231U,이상득,李相得,한나라당,경북 포항시남구울릉군,17,1,16,1,3,0,0,0,7,0,6,0,0,0,1,0,0,0,0,0,0,0,0,1,2,0,0,0,7,0,6,0,0
제18대,M8T3316Q,이종혁,李鍾赫,한나라당,부산 부산진구을,528,59,469,13,32,14,0,0,154,37,278,0,0,1,4,2,0,0,16,4,32,0,0,12,28,12,0,0,138,33,246,0,0
제18대,9MG6704Y,임동규,林東奎,한나라당,비례대표,906,118,788,19,54,11,1,0,307,66,448,0,0,2,1,0,0,0,32,11,72,0,0,17,53,11,1,0,275,55,376,0,0
제18대,TJT1453B,현기환,玄伎煥,한나라당,부산 사하구갑,577,28,549,13,36,5,0,0,205,43,275,0,0,0,2,0,0,0,13,2,11,0,0,13,34,5,0,0,192,41,264,0,0
제18대,RCF90176,김성식,金成植,한나라당,서울 관악구갑,225,31,194,8,12,1,0,0,81,18,105,0,0,0,2,0,0,0,19,1,9,0,0,8,10,1,0,0,62,17,96,0,0
제18대,UDB9699P,김호연,金昊淵,한나라당,충남 천안시을,195,11,184,0,11,1,0,0,53,15,115,0,0,0,1,0,0,0,5,2,3,0,0,0,10,1,0,0,48,13,112,0,0
제18대,SPY40975,이성남,李成男,통합민주당,비례대표,685,27,658,119,7,0,0,0,193,150,216,0,0,0,0,0,0,0,10,2,15,0,0,119,7,0,0,0,183,148,201,0,0
제18대,8JS3570T,조영택,趙泳澤,통합민주당,광주 서구갑,930,48,882,12,11,8,0,0,229,50,620,0,0,0,0,0,0,0,7,3,38,0,0,12,11,8,0,0,222,47,582,0,0
제18대,NYV25701,김효재,金孝在,한나라당,서울 성북구을,651,16,635,9,29,6,0,0,228,54,325,0,0,0,0,0,0,0,6,3,7,0,0,9,29,6,0,0,222,51,318,0,0
제18대,JBM92636,배은희,裵恩姬,한나라당,비례대표,439,42,397,12,32,10,0,0,167,27,191,0,0,2,4,1,0,0,18,1,16,0,0,10,28,9,0,0,149,26,175,0,0
제18대,AJV31724,이학재,李鶴宰,한나라당,인천 서구강화군갑,284,26,258,5,13,8,0,0,93,24,141,0,0,1,1,0,0,0,7,2,15,0,0,4,12,8,0,0,86,22,126,0,0
제18대,PPY48864,진수희,陳壽姬,한나라당,서울 성동구갑,491,104,387,126,10,9,0,0,124,144,78,0,0,8,1,1,0,0,22,62,10,0,0,118,9,8,0,0,102,82,68,0,0
제18대,RN65198P,최병국,崔炳國,한나라당,울산 남구갑,171,12,159,4,7,5,0,0,51,13,91,0,0,0,0,0,0,0,3,0,9,0,0,4,7,5,0,0,48,13,82,0,0
제18대,OE127272,허태열,許泰烈,한나라당,부산 북구강서구을,265,17,248,7,16,5,1,0,93,20,123,0,0,0,1,0,0,0,7,3,6,0,0,7,15,5,1,0,86,17,117,0,0
제18대,NAL4555X,홍준표,洪準杓,한나라당,서울 동대문구을,314,225,89,5,9,204,0,0,20,7,69,0,0,3,0,203,0,0,5,5,9,0,0,2,9,1,0,0,15,2,60,0,0
제18대,WNQ9029K,박상돈,朴商敦,자유선진당,충남 천안시을,406,46,360,3,9,13,0,0,153,43,185,0,0,0,0,1,0,0,15,8,22,0,0,3,9,12,0,0,138,35,163,0,0
제18대,YLM92014,박순자,朴順子,한나라당,경기 안산시단원구을,335,47,288,5,17,6,0,0,99,29,179,0,0,0,0,0,0,0,8,8,31,0,0,5,17,6,0,0,91,21,148,0,0
제18대,QKO6165V,박진,朴振,한나라당,서울 종로구,77,5,72,3,3,2,0,0,19,5,45,0,0,0,0,1,0,0,0,0,4,0,0,3,3,1,0,0,19,5,41,0,0
제18대,Z206474J,서상기,徐相箕,한나라당,대구 북구을,579,30,549,14,34,11,0,0,182,31,307,0,0,0,4,1,0,0,8,0,17,0,0,14,30,10,0,0,174,31,290,0,0
제18대,DX05874I,임영호,林榮鎬,자유선진당,대전 동구,965,32,933,18,31,24,0,0,321,81,490,0,0,0,0,1,0,0,16,4,11,0,0,18,31,23,0,0,305,77,479,0,0
제18대,JGX8852O,고흥길,高興吉,한나라당,경기 성남시분당구갑,170,12,158,4,12,2,1,0,54,8,89,0,0,1,1,2,0,0,2,1,5,0,0,3,11,0,1,0,52,7,84,0,0
제18대,NS06841K,이철우,李喆雨,한나라당,경북 김천시,342,32,310,10,25,7,0,0,121,20,159,0,0,0,1,0,0,0,13,2,16,0,0,10,24,7,0,0,108,18,143,0,0
제18대,V2R7430Z,이춘석,李春錫,통합민주당,전북 익산시갑,718,54,664,10,19,6,0,0,192,28,463,0,0,0,0,0,0,0,9,2,43,0,0,10,19,6,0,0,183,26,420,0,0
제18대,LIR7134B,이한정,李漢正,창조한국당,비례대표,3,0,3,1,0,0,0,0,1,0,1,0,0,0,0,0,0,0,0,0,0,0,0,1,0,0,0,0,1,0,1,0,0
제18대,ARP89147,정동영,鄭東泳,무소속,전북 전주시덕진구,239,7,232,0,5,0,0,0,45,6,183,0,0,0,0,0,0,0,1,0,6,0,0,0,5,0,0,0,44,6,177,0,0
제18대,SNJ6318D,김무성,金武星,무소속,부산 남구을,434,8,426,10,20,1,0,0,156,34,213,0,0,0,1,0,0,0,6,0,1,0,0,10,19,1,0,0,150,34,212,0,0
제18대,3O66539X,김성곤,金星坤,통합민주당,전남 여수시갑,1241,42,1199,9,39,16,0,0,372,98,707,0,0,0,0,0,0,0,15,4,23,0,0,9,39,16,0,0,357,94,684,0,0
제18대,P6Q6720D,김성순,金聖順,통합민주당,서울 송파구병,418,24,394,2,10,7,0,0,151,48,200,0,0,0,0,0,0,0,8,6,10,0,0,2,10,7,0,0,143,42,190,0,0
제18대,4HB8518T,박근혜,朴槿惠,한나라당,대구 달성군,29,10,19,2,10,0,0,0,11,3,3,0,0,0,5,0,0,0,5,0,0,0,0,2,5,0,0,0,6,3,3,0,0
제18대,DGR8579Q,윤영,尹英,한나라당,경남 거제시,494,72,422,4,20,4,1,0,156,49,260,0,0,0,3,0,0,0,20,8,41,0,0,4,17,4,1,0,136,41,219,0,0
제18대,HC725148,이용경,李容璟,창조한국당,비례대표,146,16,130,1,5,2,0,0,44,4,90,0,0,1,0,0,0,0,4,0,11,0,0,0,5,2,0,0,40,4,79,0,0
제18대,ZAD6422F,허천,,한나라당,강원 춘천시,297,33,264,5,14,2,0,0,91,34,151,0,0,0,1,0,0,0,14,7,11,0,0,5,13,2,0,0,77,27,140,0,0
제18대,X0R95148,강기갑,姜基甲,민주노동당,경남 사천시,669,72,597,4,20,8,0,0,193,47,397,0,0,0,1,1,0,0,20,8,42,0,0,4,19,7,0,0,173,39,355,0,0
제18대,M3Z17237,김재경,金在庚,한나라당,경남 진주시을,234,26,208,7,21,3,0,0,76,18,109,0,0,0,1,0,0,0,10,2,13,0,0,7,20,3,0,0,66,16,96,0,0
제18대,3ZP1685J,박기춘,朴起春,통합민주당,경기 남양주시을,599,37,562,7,17,7,0,0,201,49,318,0,0,0,2,0,0,0,10,5,20,0,0,7,15,7,0,0,191,44,298,0,0
제18대,8DK7238W,백재현,白在鉉,통합민주당,경기 광명시갑,689,46,643,4,17,5,0,0,186,46,431,0,0,1,2,0,0,0,19,5,19,0,0,3,15,5,0,0,167,41,412,0,0
제18대,NH229893,전여옥,田麗玉,한나라당,서울 영등포구갑,97,13,84,3,6,3,0,0,31,20,34,0,0,0,0,0,0,0,5,2,6,0,0,3,6,3,0,0,26,18,28,0,0
제18대,5YX7831C,정몽준,鄭夢準,한나라당,서울 동작구을,36,4,32,2,3,1,0,0,9,2,19,0,0,0,0,0,0,0,1,0,3,0,0,2,3,1,0,0,8,2,16,0,0
제18대,0E97245Y,정양석,鄭亮碩,한나라당,서울 강북구갑,277,11,266,3,13,3,0,0,97,27,134,0,0,0,0,0,0,0,3,2,6,0,0,3,13,3,0,0,94,25,128,0,0
제18대,ZX71333R,한선교,韓善敎,무소속,경기 용인시수지구,658,79,579,13,43,6,0,0,232,45,319,0,0,0,5,0,0,0,27,3,44,0,0,13,38,6,0,0,205,42,275,0,0
제18대,4B859597,서종표,徐鍾杓,통합민주당,비례대표,205,15,190,0,11,2,0,0,48,17,127,0,0,0,3,0,0,0,3,0,9,0,0,0,8,2,0,0,45,17,118,0,0
제18대,FGX4881A,심재철,沈在哲,한나라당,경기 안양시동안구을,298,74,224,5,12,8,0,0,95,17,161,0,0,0,5,2,0,0,20,3,44,0,0,5,7,6,0,0,75,14,117,0,0
제18대,FPX1564S,안홍준,安鴻俊,한나라당,경남 마산시을,796,73,723,12,40,12,2,0,232,74,424,0,0,0,2,1,0,0,15,7,48,0,0,12,38,11,2,0,217,67,376,0,0
제18대,ZG482421,이상권,李商權,한나라당,인천 계양구을,95,9,86,2,3,2,2,0,26,2,58,0,0,0,0,0,0,0,2,0,7,0,0,2,3,2,2,0,24,2,51,0,0
제18대,N3Q3468A,김우남,金宇南,통합민주당,제주 제주시을,1259,195,1064,19,56,16,0,0,356,98,714,0,0,7,9,0,0,0,39,19,121,0,0,12,47,16,0,0,317,79,593,0,0
제18대,MO52543L,변재일,卞在一,통합민주당,충북 청원군,399,32,367,6,6,8,0,0,125,23,231,0,0,1,1,0,0,0,10,1,19,0,0,5,5,8,0,0,115,22,212,0,0
제18대,PU97362N,이영애,李榮愛,한나라당,비례대표,0,0,0,0,0,0,0,0,0,0,0,0,0,0,0,0,0,0,0,0,0,0,0,0,0,0,0,0,0,0,0,0,0
제18대,S3072602,진성호,秦聖昊,한나라당,서울 중랑구을,309,27,282,7,22,3,0,0,102,26,149,0,0,1,1,0,0,0,5,3,17,0,0,6,21,3,0,0,97,23,132,0,0
제18대,RK22879B,박상은,朴商銀,한나라당,인천 중구동구옹진군,244,16,228,5,12,4,0,0,77,25,121,0,0,0,0,0,0,0,9,1,6,0,0,5,12,4,0,0,68,24,115,0,0
제18대,7AN97172,이정현,李貞鉉,한나라당,비례대표,240,31,209,5,17,1,0,0,91,14,112,0,0,0,3,0,0,0,16,0,12,0,0,5,14,1,0,0,75,14,100,0,0
제18대,OTR59398,정미경,鄭美京,한나라당,경기 수원시권선구,348,29,319,8,17,4,0,0,101,35,183,0,0,0,0,0,0,0,9,6,14,0,0,8,17,4,0,0,92,29,169,0,0
제18대,XBJ9297Q,노영민,盧英敏,통합민주당,충북 청주시흥덕구을,508,43,465,3,18,9,0,0,166,32,280,0,0,3,5,0,0,0,13,3,19,0,0,0,13,9,0,0,153,29,261,0,0
제18대,NG55346W,전병헌,田炳憲,통합민주당,서울 동작구갑,739,34,705,121,17,1,0,0,176,158,266,0,0,0,3,0,0,0,11,3,17,0,0,121,14,1,0,0,165,155,249,0,0
제18대,S7E4736F,윤진식,尹鎭植,한나라당,충북 충주시,59,1,58,1,3,1,0,0,25,4,25,0,0,0,0,0,0,0,1,0,0,0,0,1,3,1,0,0,24,4,25,0,0
제18대,A5D8747O,이정희,李正姬,민주노동당,비례대표,376,47,329,0,5,6,0,0,103,21,241,0,0,0,0,2,0,0,20,0,25,0,0,0,5,4,0,0,83,21,216,0,0
제18대,HJG1284F,정하균,鄭河均,친박연대,비례대표,374,25,349,3,16,3,0,0,126,29,197,0,0,0,1,0,0,0,6,2,16,0,0,3,15,3,0,0,120,27,181,0,0
제18대,L3981924,조문환,曺文煥,한나라당,비례대표,340,14,326,6,25,10,1,0,88,21,189,0,0,0,1,0,0,0,4,2,7,0,0,6,24,10,1,0,84,19,182,0,0
제18대,C6R4461P,박선영,朴宣映,자유선진당,비례대표,414,42,372,0,6,16,0,0,123,39,230,0,0,0,1,0,0,0,11,1,29,0,0,0,5,16,0,0,112,38,201,0,0
제18대,PVV68260,손범규,孫範奎,한나라당,경기 고양시덕양구갑,1514,54,1460,139,52,10,1,0,453,254,605,0,0,0,0,0,0,0,18,7,29,0,0,139,52,10,1,0,435,247,576,0,0
제18대,QKY38290,여상규,余尙奎,한나라당,경남 남해군하동군,373,25,348,7,32,5,0,0,127,26,176,0,0,1,1,1,0,0,6,3,13,0,0,6,31,4,0,0,121,23,163,0,0
제18대,63J3777V,유정복,劉正福,한나라당,경기 김포시,150,19,131,3,10,1,0,0,41,18,77,0,0,0,1,0,0,0,3,1,14,0,0,3,9,1,0,0,38,17,63,0,0
제18대,KDL4367Q,김학송,金鶴松,한나라당,경남 진해시,253,28,225,4,16,6,0,0,60,13,154,0,0,0,0,0,0,0,3,3,22,0,0,4,16,6,0,0,57,10,132,0,0
제18대,R7753197,우윤근,禹潤根,통합민주당,전남 광양시,501,52,449,7,23,6,0,0,177,30,258,0,0,2,5,2,0,0,17,1,25,0,0,5,18,4,0,0,160,29,233,0,0
제18대,4A067125,이광재,李光宰,통합민주당,"강원 태백시,영월,평창,정선군",149,16,133,2,9,1,0,0,59,10,68,0,0,0,1,0,0,0,7,0,8,0,0,2,8,1,0,0,52,10,60,0,0
제18대,ZHD57353,이범래,李泛來,한나라당,서울 구로구갑,657,12,645,127,21,4,0,0,167,157,181,0,0,0,2,0,0,0,2,1,7,0,0,127,19,4,0,0,165,156,174,0,0
