대수,국회의원코드,국회의원명,국회의원한자명,정당명,선거구명,발의수(전체),발의수(대표발의),발의수(공동발의),원안가결(전체),수정가결(전체),철회(전체),부결(전체),수정안반영폐기(전체),대안반영폐기(전체),폐기(전체),임기만료폐기(전체),회기불계속폐기(전체),기타(전체),원안가결(대표발의),수정가결(대표발의),철회(대표발의),부결(대표발의),수정안반영폐기(대표발의),대안반영폐기(대표발의),폐기(대표발의),임기만료폐기(대표발의),회기불계속폐기(대표발의),기타,원안가결(공동발의),수정가결(공동발의),철회(공동발의),부결(공동발의),수정안반영폐기(공동발의),대안반영폐기(공동발의),폐기(공동발의),임기만료폐기(공동발의),회기불계속폐기(공동발의),기타(공동발의)
제17대,ACS7139Z,안상수,安商守,한나라당,"경기 의왕,과천시",1178,92,1086,37,96,20,0,0,319,89,617,0,0,6,18,3,0,0,6,4,55,0,0,31,78,17,0,0,313,85,562,0,0
제17대,V0O5343U,우상호,禹相虎,열린우리당,서울특별시 서대문구갑,235,16,219,7,32,4,1,0,52,13,126,0,0,2,4,0,0,0,5,1,4,0,0,5,28,4,1,0,47,12,122,0,0
제17대,9ZP9014Q,이해찬,李海瓚,열린우리당,서울특별시 관악구을,4,0,4,0,1,0,0,0,3,0,0,0,0,0,0,0,0,0,0,0,0,0,0,0,1,0,0,0,3,0,0,0,0
제17대,2QE48823,장윤석,張倫碩,한나라당,경상북도 영주시,207,18,189,8,28,2,0,0,39,10,120,0,0,0,0,0,0,0,4,3,11,0,0,8,28,2,0,0,35,7,109,0,0
제17대,FJ03481D,최경환,崔炅煥,한나라당,"경상북도 경산시,청도군",331,15,316,10,39,5,0,0,81,30,166,0,0,1,1,0,0,0,7,1,5,0,0,9,38,5,0,0,74,29,161,0,0
제17대,H2X6452Y,김용갑,金容甲,한나라당,"경상남도 밀양시,창녕군",200,2,198,9,37,0,0,0,47,13,94,0,0,0,0,0,0,0,1,0,1,0,0,9,37,0,0,0,46,13,93,0,0
제17대,QKO6165V,박진,朴振,한나라당,서울특별시 종로구,143,5,138,6,27,3,0,0,25,8,74,0,0,0,0,0,0,0,0,0,5,0,0,6,27,3,0,0,25,8,69,0,0
제17대,EWR39555,주성영,朱盛英,한나라당,대구 동구갑,247,16,231,9,33,3,0,0,51,12,139,0,0,0,1,0,0,0,0,2,13,0,0,9,32,3,0,0,51,10,126,0,0
제17대,0Y39862U,최철국,崔喆國,열린우리당,경남 김해시을,298,13,285,8,53,5,0,0,94,16,122,0,0,1,3,0,0,0,3,0,6,0,0,7,50,5,0,0,91,16,116,0,0
제17대,4G45218X,심대평,沈大平,국민중심당,대전 서구을,17,1,16,1,2,0,0,0,5,0,9,0,0,0,0,0,0,0,1,0,0,0,0,1,2,0,0,0,4,0,9,0,0
제17대,G7D4763A,장영달,張永達,열린우리당,전북 전주시완산구갑,269,8,261,6,27,5,0,0,85,4,142,0,0,0,2,1,0,0,1,0,4,0,0,6,25,4,0,0,84,4,138,0,0
제17대,QZG38143,김춘진,金椿鎭,열린우리당,"전라북도 고창,부안군",374,36,338,13,44,3,0,0,117,13,184,0,0,1,2,1,0,0,12,1,19,0,0,12,42,2,0,0,105,12,165,0,0
제17대,ZKU1175F,노현송,盧顯松,열린우리당,서울특별시 강서구을,655,15,640,22,80,13,0,0,205,38,297,0,0,1,3,0,0,0,4,1,6,0,0,21,77,13,0,0,201,37,291,0,0
제17대,1FK74463,류근찬,柳根粲,자유민주연합,"충남 보령시,서천군",274,7,267,9,21,1,0,0,89,17,137,0,0,0,0,0,0,0,1,0,6,0,0,9,21,1,0,0,88,17,131,0,0
제17대,RYL1698T,문병호,文炳浩,열린우리당,인천광역시 부평구갑,218,34,184,7,26,1,0,0,75,15,94,0,0,1,2,0,0,0,12,2,17,0,0,6,24,1,0,0,63,13,77,0,0
제17대,GJ56729D,복기왕,卜箕旺,열린우리당,충청남도 아산시,75,2,73,1,13,1,0,0,36,3,21,0,0,0,1,0,0,0,1,0,0,0,0,1,12,1,0,0,35,3,21,0,0
제17대,T8H6713N,최연희,崔鉛熙,한나라당,강원 동해삼척시,54,4,50,0,6,0,0,0,16,3,29,0,0,0,1,0,0,0,3,0,0,0,0,0,5,0,0,0,13,3,29,0,0
제17대,WVT1840E,김기춘,金淇春,한나라당,경상남도 거제시,112,2,110,6,25,1,0,0,22,7,51,0,0,0,0,0,0,0,0,0,2,0,0,6,25,1,0,0,22,7,49,0,0
제17대,4RF2451S,김원기,金元基,열린우리당,전라북도 정읍시,26,1,25,0,5,0,0,0,3,0,18,0,0,0,0,0,0,0,1,0,0,0,0,0,5,0,0,0,2,0,18,0,0
제17대,8BY8620U,이용희,李龍熙,열린우리당,"충청북도 보은,옥천,영동군",69,2,67,2,10,0,0,0,26,3,28,0,0,0,1,0,0,0,1,0,0,0,0,2,9,0,0,0,25,3,28,0,0
제17대,AFM9947E,김종률,金鍾律,열린우리당,"충북 진천,괴산,음성군",429,19,410,13,43,6,0,0,151,30,186,0,0,7,1,0,0,0,4,2,5,0,0,6,42,6,0,0,147,28,181,0,0
제17대,0135473I,이군현,李君賢,한나라당,비례대표,255,15,240,11,30,4,0,0,67,17,126,0,0,0,0,1,0,0,8,0,6,0,0,11,30,3,0,0,59,17,120,0,0
제17대,W8L79935,이강두,李康斗,한나라당,"경남 산청,함양,거창군",292,7,285,9,42,5,0,0,77,15,144,0,0,0,1,0,0,0,0,1,5,0,0,9,41,5,0,0,77,14,139,0,0
제17대,BEH5300E,이계경,李啓卿,한나라당,비례대표,821,61,760,29,74,5,0,0,212,61,440,0,0,1,6,1,0,0,17,9,27,0,0,28,68,4,0,0,195,52,413,0,0
제17대,RUW8681N,황진하,黃震夏,한나라당,비례대표,299,11,288,12,30,6,0,0,63,16,172,0,0,0,0,1,0,0,2,0,8,0,0,12,30,5,0,0,61,16,164,0,0
제17대,BLC8630L,박병석,朴炳錫,열린우리당,대전광역시 서구갑,125,10,115,0,17,2,0,0,53,10,43,0,0,0,0,0,0,0,3,2,5,0,0,0,17,2,0,0,50,8,38,0,0
제17대,TAJ3272G,우제항,禹濟恒,열린우리당,경기도 평택시갑,263,18,245,8,51,3,0,0,75,16,110,0,0,0,5,0,0,0,7,0,6,0,0,8,46,3,0,0,68,16,104,0,0
제17대,MZD1909P,이방호,李方鎬,한나라당,경상남도 사천시,133,4,129,6,26,0,0,0,32,6,63,0,0,0,1,0,0,0,1,0,2,0,0,6,25,0,0,0,31,6,61,0,0
제17대,QT984813,신학용,辛鶴用,열린우리당,인천 계양구갑,475,28,447,12,45,11,0,0,141,28,238,0,0,1,3,0,0,0,8,1,15,0,0,11,42,11,0,0,133,27,223,0,0
제17대,4A067125,이광재,李光宰,열린우리당,강원 태백시정선군,160,10,150,13,31,2,0,0,41,10,63,0,0,0,2,0,0,0,2,2,4,0,0,13,29,2,0,0,39,8,59,0,0
제17대,T3M8349A,배일도,裵一道,한나라당,비례대표,838,25,813,20,80,8,0,0,228,73,429,0,0,0,4,0,0,0,5,4,12,0,0,20,76,8,0,0,223,69,417,0,0
제17대,SU53086M,심상정,沈相정,민주노동당,비례대표,422,48,374,11,12,4,0,0,104,40,251,0,0,0,1,1,0,0,14,6,26,0,0,11,11,3,0,0,90,34,225,0,0
제17대,AEF95742,유재건,柳在乾,열린우리당,서울특별시 성북구갑,215,8,207,5,23,5,0,0,53,3,126,0,0,0,0,0,0,0,1,0,7,0,0,5,23,5,0,0,52,3,119,0,0
제17대,HGU6642R,곽성문,郭成文,한나라당,"대구 중구,남구",353,7,346,16,30,4,1,0,86,24,192,0,0,0,0,1,0,0,0,0,6,0,0,16,30,3,1,0,86,24,186,0,0
제17대,64G6894C,김정훈,金正薰,한나라당,부산 남구,488,23,465,11,51,7,0,0,127,47,245,0,0,0,1,0,0,0,6,2,14,0,0,11,50,7,0,0,121,45,231,0,0
제17대,PPY48864,진수희,陳壽姬,한나라당,비례대표,402,15,387,13,43,5,0,0,121,28,192,0,0,0,0,0,0,0,6,0,9,0,0,13,43,5,0,0,115,28,183,0,0
제17대,IUR8211H,강혜숙,姜惠淑,열린우리당,비례대표,437,9,428,18,45,6,0,0,121,20,227,0,0,0,0,0,0,0,4,0,5,0,0,18,45,6,0,0,117,20,222,0,0
제17대,PJW7804X,김근태,金槿泰,열린우리당,서울특별시 도봉구갑,58,0,58,0,5,0,0,0,16,1,36,0,0,0,0,0,0,0,0,0,0,0,0,0,5,0,0,0,16,1,36,0,0
제17대,5JX61739,박홍수,朴弘綬,열린우리당,비례(열) 비례(열린우리당),70,4,66,1,14,1,0,0,29,3,22,0,0,0,0,0,0,0,2,0,2,0,0,1,14,1,0,0,27,3,20,0,0
제17대,K4669042,권철현,權哲賢,한나라당,부산광역시 사상구,241,8,233,15,41,1,0,0,60,12,112,0,0,2,0,0,0,0,5,0,1,0,0,13,41,1,0,0,55,12,111,0,0
제17대,LLT3669K,김영숙,金英淑,한나라당,비례대표,298,21,277,9,37,5,0,0,73,30,144,0,0,1,1,1,0,0,7,3,8,0,0,8,36,4,0,0,66,27,136,0,0
제17대,39P2522W,민병두,閔丙두,열린우리당,비례대표,318,27,291,11,40,4,0,0,94,13,156,0,0,1,1,0,0,0,3,0,22,0,0,10,39,4,0,0,91,13,134,0,0
제17대,GFO6700V,우제창,禹濟昌,열린우리당,경기도 용인시갑,564,22,542,12,61,6,0,0,185,38,262,0,0,0,4,0,0,0,6,3,9,0,0,12,57,6,0,0,179,35,253,0,0
제17대,17671841,김태홍,金泰弘,열린우리당,광주광역시 북구을,712,13,699,29,78,9,0,0,216,43,337,0,0,0,2,0,0,0,6,0,5,0,0,29,76,9,0,0,210,43,332,0,0
제17대,I5T29903,김학원,金學元,자유민주연합,"충남 부여군,청양군",113,5,108,8,21,3,0,0,19,2,60,0,0,0,2,0,0,0,2,0,1,0,0,8,19,3,0,0,17,2,59,0,0
제17대,MWY71007,안병엽,安炳燁,열린우리당,경기 화성시,355,9,346,9,41,4,0,0,128,27,146,0,0,0,1,0,0,0,5,0,3,0,0,9,40,4,0,0,123,27,143,0,0
제17대,B9410875,이영순,李永順,민주노동당,비례대표,447,45,402,11,17,4,0,0,104,40,271,0,0,6,1,0,0,0,12,0,26,0,0,5,16,4,0,0,92,40,245,0,0
제17대,6NE2017V,최성,崔星,열린우리당,경기도 고양시덕양구을,282,8,274,5,29,4,0,0,72,12,160,0,0,0,0,0,0,0,0,0,8,0,0,5,29,4,0,0,72,12,152,0,0
제17대,ZLG77338,구논회,具論會,열린우리당,대전광역시 서구을,238,14,224,9,26,4,0,0,101,17,81,0,0,1,1,0,0,0,5,1,6,0,0,8,25,4,0,0,96,16,75,0,0
제17대,QZU9232M,김재원,金在原,한나라당,"경북 군위,의성군",827,17,810,26,72,16,0,0,223,73,417,0,0,0,0,0,0,0,6,2,9,0,0,26,72,16,0,0,217,71,408,0,0
제17대,0WH9705X,전재희,全在姬,한나라당,경기 광명시을,159,8,151,7,24,0,0,0,41,15,72,0,0,0,1,0,0,0,2,2,3,0,0,7,23,0,0,0,39,13,69,0,0
제17대,AKX56559,조일현,曺馹鉉,열린우리당,"강원도 홍천,횡성군",289,15,274,7,40,3,0,0,110,20,109,0,0,0,7,1,0,0,5,1,1,0,0,7,33,2,0,0,105,19,108,0,0
제17대,52Z10964,신국환,辛國煥,무소속,"경상북도 문경시,예천군",291,5,286,10,31,1,0,0,103,22,124,0,0,0,0,0,0,0,0,0,5,0,0,10,31,1,0,0,103,22,119,0,0
제17대,UUE26413,장향숙,張香淑,열린우리당,비례대표,504,39,465,16,52,9,0,0,165,21,241,0,0,0,5,0,0,0,16,0,18,0,0,16,47,9,0,0,149,21,223,0,0
제17대,H5476989,한병도,韓秉道,열린우리당,전북 익산시,363,16,347,9,57,7,0,0,111,19,160,0,0,0,3,2,0,0,4,1,6,0,0,9,54,5,0,0,107,18,154,0,0
제17대,FSN5613H,박희태,朴熺太,한나라당,"경상남도 남해,하동군",109,1,108,6,22,0,0,0,18,4,59,0,0,0,1,0,0,0,0,0,0,0,0,6,21,0,0,0,18,4,59,0,0
제17대,6DG91769,원혜영,元惠榮,열린우리당,경기도 부천시오정구,228,9,219,14,43,7,0,0,52,11,101,0,0,2,1,0,0,0,4,0,2,0,0,12,42,7,0,0,48,11,99,0,0
제17대,VO548788,유인태,柳寅泰,열린우리당,서울특별시 도봉구을,76,3,73,3,17,1,0,0,26,1,28,0,0,0,0,0,0,0,0,0,3,0,0,3,17,1,0,0,26,1,25,0,0
제17대,32X1773B,임종인,林鍾仁,열린우리당,경기 안산시상록구을,431,54,377,8,27,7,0,0,114,22,253,0,0,2,1,3,0,0,4,4,40,0,0,6,26,4,0,0,110,18,213,0,0
제17대,VF63237H,홍미영,洪美英,열린우리당,비례대표,412,23,389,12,50,7,0,0,122,20,201,0,0,1,2,0,0,0,7,0,13,0,0,11,48,7,0,0,115,20,188,0,0
제17대,SSH8397C,김낙성,金洛聖,자유민주연합,충남 당진군,198,13,185,2,26,1,0,0,62,9,98,0,0,1,0,0,0,0,5,0,7,0,0,1,26,1,0,0,57,9,91,0,0
제17대,C687242Z,안명옥,安明玉,한나라당,비례대표,568,143,425,15,56,7,0,0,136,46,308,0,0,0,14,1,0,0,32,19,77,0,0,15,42,6,0,0,104,27,231,0,0
제17대,8QY4415F,문희,文姬,한나라당,비례대표,254,25,229,17,25,4,0,0,40,8,160,0,0,0,0,2,0,0,5,1,17,0,0,17,25,2,0,0,35,7,143,0,0
제17대,SVH30067,오제세,吳濟世,열린우리당,충청북도 청주시흥덕구,422,39,383,11,52,7,0,0,150,35,167,0,0,0,2,1,0,0,19,4,13,0,0,11,50,6,0,0,131,31,154,0,0
제17대,CYD5815E,정갑윤,鄭甲潤,한나라당,울산광역시 중구,436,21,415,13,52,9,0,0,120,20,222,0,0,1,2,0,0,0,6,2,10,0,0,12,50,9,0,0,114,18,212,0,0
제17대,P924524G,정화원,鄭和元,한나라당,비례대표,393,38,355,13,31,6,0,0,105,22,216,0,0,0,1,0,0,0,13,1,23,0,0,13,30,6,0,0,92,21,193,0,0
제17대,R724713H,김재윤,金才允,열린우리당,"제주도 서귀포시,남제주군",632,28,604,16,51,5,1,0,182,24,353,0,0,1,4,0,0,0,6,1,16,0,0,15,47,5,1,0,176,23,337,0,0
제17대,XBJ9297Q,노영민,盧英敏,열린우리당,충북 청주시흥덕구을,497,18,479,18,62,9,0,0,165,33,210,0,0,0,2,0,0,0,8,1,7,0,0,18,60,9,0,0,157,32,203,0,0
제17대,D7L1937J,이병석,李秉錫,한나라당,경상북도 포항시북구,189,25,164,14,24,1,0,0,42,15,93,0,0,2,2,1,0,0,6,3,11,0,0,12,22,0,0,0,36,12,82,0,0
제17대,NQR1206Q,정진석,鄭鎭碩,무소속,"충남 공주시,연기군",147,10,137,7,26,0,0,0,36,3,75,0,0,0,1,0,0,0,4,0,5,0,0,7,25,0,0,0,32,3,70,0,0
제17대,3KB30916,김기석,金基錫,열린우리당,경기도 부천시원미구갑,106,4,102,6,12,2,0,0,46,7,33,0,0,1,0,0,0,0,1,2,0,0,0,5,12,2,0,0,45,5,33,0,0
제17대,WZL8101U,박혁규,朴赫圭,한나라당,경기 광주군,24,2,22,1,2,1,0,0,7,5,8,0,0,1,0,0,0,0,0,1,0,0,0,0,2,1,0,0,7,4,8,0,0
제17대,TOU1222X,강창일,姜昌一,열린우리당,제주 북제주군갑,602,40,562,18,65,6,0,0,164,30,319,0,0,3,8,0,0,0,6,2,21,0,0,15,57,6,0,0,158,28,298,0,0
제17대,P303213F,정병국,鄭柄國,한나라당,"경기 가평군,양평군",625,33,592,15,52,9,1,0,158,64,326,0,0,0,0,0,1,0,8,4,20,0,0,15,52,9,0,0,150,60,306,0,0
제17대,RN65198P,최병국,崔炳國,한나라당,울산 남구갑,187,4,183,8,31,3,0,0,35,3,107,0,0,0,0,1,0,0,0,0,3,0,0,8,31,2,0,0,35,3,104,0,0
제17대,XY451321,김맹곤,金孟坤,열린우리당,경남 김해시,64,6,58,5,9,1,0,0,28,6,15,0,0,0,0,0,0,0,4,1,1,0,0,5,9,1,0,0,24,5,14,0,0
제17대,1OP1897P,김홍일,金弘一,새천년민주당,비례대표,105,0,105,1,13,3,0,0,37,10,41,0,0,0,0,0,0,0,0,0,0,0,0,1,13,3,0,0,37,10,41,0,0
제17대,NAL4555X,홍준표,洪準杓,한나라당,서울특별시 동대문구을,128,9,119,6,20,1,1,0,26,4,70,0,0,0,1,0,1,0,1,0,6,0,0,6,19,1,0,0,25,4,64,0,0
제17대,OIU86868,고희선,高羲善,한나라당,경기 화성시,80,4,76,8,20,2,0,0,10,2,38,0,0,0,0,0,0,0,0,0,4,0,0,8,20,2,0,0,10,2,34,0,0
제17대,Z206474J,서상기,徐相箕,한나라당,비례대표,278,9,269,9,32,4,0,0,53,16,164,0,0,0,4,0,0,0,2,1,2,0,0,9,28,4,0,0,51,15,162,0,0
제17대,IU67432G,강재섭,姜在涉,한나라당,대구광역시 서구,141,5,136,7,31,1,0,0,32,8,62,0,0,0,1,0,0,0,2,0,2,0,0,7,30,1,0,0,30,8,60,0,0
제17대,YLM7354D,유필우,柳弼祐,열린우리당,인천광역시 남구갑,157,10,147,4,17,4,0,0,58,6,68,0,0,1,2,0,0,0,4,0,3,0,0,3,15,4,0,0,54,6,65,0,0
제17대,NDH62175,이재오,李在五,한나라당,서울특별시 은평구을,446,15,431,11,54,10,0,0,128,42,201,0,0,0,1,0,0,0,1,4,9,0,0,11,53,10,0,0,127,38,192,0,0
제17대,K2813994,김영대,金榮大,대통합민주신당,비례대표,16,2,14,0,1,0,0,0,2,0,13,0,0,0,0,0,0,0,0,0,2,0,0,0,1,0,0,0,2,0,11,0,0
제17대,SLW27496,나경원,羅景垣,한나라당,비례대표,380,27,353,9,46,10,0,0,90,26,199,0,0,0,4,0,0,0,9,0,14,0,0,9,42,10,0,0,81,26,185,0,0
제17대,E2O7996B,신기남,辛基南,열린우리당,서울특별시 강서구갑,193,2,191,3,23,2,0,0,56,12,97,0,0,0,0,0,0,0,1,1,0,0,0,3,23,2,0,0,55,11,97,0,0
제17대,NH229893,전여옥,田麗玉,한나라당,비례대표,211,11,200,7,25,2,0,0,44,15,118,0,0,0,0,1,0,0,3,0,7,0,0,7,25,1,0,0,41,15,111,0,0
제17대,Q9H5708M,김진표,金振杓,열린우리당,경기 수원시영통구,103,8,95,9,14,1,0,0,34,6,39,0,0,0,2,0,0,0,1,0,5,0,0,9,12,1,0,0,33,6,34,0,0
제17대,H0G8409H,김충환,金忠環,한나라당,서울특별시 강동구갑,443,26,417,21,43,8,0,0,108,28,235,0,0,0,1,4,0,0,5,1,15,0,0,21,42,4,0,0,103,27,220,0,0
제17대,XXJ47169,문석호,文錫鎬,열린우리당,"충청남도 서산시,태안군",184,14,170,7,25,1,0,0,70,12,69,0,0,0,2,0,0,0,4,1,7,0,0,7,23,1,0,0,66,11,62,0,0
제17대,WNQ9029K,박상돈,朴商敦,열린우리당,충청남도 천안시을,946,53,893,27,73,15,0,0,304,54,473,0,0,5,8,0,0,0,20,3,17,0,0,22,65,15,0,0,284,51,456,0,0
제17대,ZYH1940A,이상민,李相珉,열린우리당,대전광역시 유성구,212,36,176,3,26,1,0,0,66,19,97,0,0,1,3,0,0,0,7,3,22,0,0,2,23,1,0,0,59,16,75,0,0
제17대,QMQ4659V,김선미,金善美,열린우리당,경기도 안성시,366,34,332,3,46,6,0,0,112,17,182,0,0,0,2,1,0,0,9,3,19,0,0,3,44,5,0,0,103,14,163,0,0
제17대,9406274S,김정부,金政夫,한나라당,경남 마산시합포구,133,10,123,2,12,0,0,0,34,18,67,0,0,0,1,0,0,0,3,5,1,0,0,2,11,0,0,0,31,13,66,0,0
제17대,OEY60882,박세환,朴世煥,한나라당,"강원 철원,화천,양구군",662,23,639,17,55,5,0,0,175,50,360,0,0,1,3,0,0,0,6,2,11,0,0,16,52,5,0,0,169,48,349,0,0
제17대,6GM6942I,안택수,安澤秀,한나라당,대구광역시 북구을,318,12,306,14,32,4,0,0,85,16,167,0,0,0,0,0,0,0,6,0,6,0,0,14,32,4,0,0,79,16,161,0,0
제17대,TIS61927,양승조,梁承晁,열린우리당,충청남도 천안시갑,382,41,341,11,37,7,0,0,108,14,205,0,0,0,2,0,0,0,12,2,25,0,0,11,35,7,0,0,96,12,180,0,0
제17대,8IN46764,이주영,李柱榮,한나라당,경남 마산시갑,87,12,75,8,24,0,0,0,10,2,43,0,0,0,5,0,0,0,1,0,6,0,0,8,19,0,0,0,9,2,37,0,0
제17대,4QP35150,정종복,鄭鍾福,한나라당,경상북도 경주시,352,12,340,13,36,8,0,0,85,30,180,0,0,0,2,0,0,0,2,0,8,0,0,13,34,8,0,0,83,30,172,0,0
제17대,TOM5642Y,고경화,高京華,한나라당,비례대표,305,22,283,7,42,8,0,0,55,15,178,0,0,0,4,0,0,0,5,1,12,0,0,7,38,8,0,0,50,14,166,0,0
제17대,K3672835,문학진,文學振,열린우리당,경기도 하남시,347,19,328,3,44,12,0,0,114,10,164,0,0,0,3,0,0,0,6,1,9,0,0,3,41,12,0,0,108,9,155,0,0
제17대,SNJ6318D,김무성,金武星,한나라당,부산 남구을,277,4,273,7,33,2,0,0,62,26,147,0,0,0,0,0,0,0,0,0,4,0,0,7,33,2,0,0,62,26,143,0,0
제17대,1TW34594,김영덕,金榮德,한나라당,"경남 의령,함안군",358,14,344,13,62,3,0,0,92,23,165,0,0,0,1,0,0,0,5,3,5,0,0,13,61,3,0,0,87,20,160,0,0
제17대,GN240959,노회찬,魯會燦,민주노동당,비례대표,426,47,379,13,12,4,0,0,106,39,252,0,0,3,1,0,0,0,11,1,31,0,0,10,11,4,0,0,95,38,221,0,0
제17대,BPZ8472N,이원복,李源馥,한나라당,인천 남동구을,95,0,95,9,21,2,0,0,11,4,48,0,0,0,0,0,0,0,0,0,0,0,0,9,21,2,0,0,11,4,48,0,0
제17대,3SP89633,천정배,千正培,열린우리당,경기 안산시단원구갑,74,3,71,1,8,3,0,0,26,3,33,0,0,0,0,0,0,0,1,0,2,0,0,1,8,3,0,0,25,3,31,0,0
제17대,1MB8686B,권경석,權炅錫,한나라당,경상남도 창원시갑,380,26,354,13,44,4,0,0,95,28,196,0,0,0,3,0,0,0,3,1,19,0,0,13,41,4,0,0,92,27,177,0,0
제17대,WFJ6020P,김덕룡,金德龍,한나라당,서울특별시 서초구을,77,2,75,6,21,1,0,0,10,2,37,0,0,0,0,0,0,0,0,0,2,0,0,6,21,1,0,0,10,2,35,0,0
제17대,PWU27609,유승민,劉承旼,한나라당,비례(한) 비례(한나라당),442,7,435,11,40,7,0,0,119,39,226,0,0,0,0,0,0,0,3,0,4,0,0,11,40,7,0,0,116,39,222,0,0
제17대,HJI9845B,이인제,李仁濟,자유민주연합,"충남 논산시,계룡시,금산군",67,0,67,1,8,0,0,0,20,4,34,0,0,0,0,0,0,0,0,0,0,0,0,1,8,0,0,0,20,4,34,0,0
제17대,DTO5670Y,정의용,鄭義溶,열린우리당,비례대표,101,5,96,3,11,3,0,0,35,1,48,0,0,0,1,0,0,0,2,0,2,0,0,3,10,3,0,0,33,1,46,0,0
제17대,IDV9108J,진영,陳永,한나라당,서울특별시 용산구,244,7,237,10,36,6,0,0,46,11,135,0,0,0,0,0,0,0,3,0,4,0,0,10,36,6,0,0,43,11,131,0,0
제17대,SOB8871D,권선택,權善宅,열린우리당,대전광역시 중구,204,10,194,6,28,3,0,0,65,14,88,0,0,0,1,0,0,0,3,1,5,0,0,6,27,3,0,0,62,13,83,0,0
제17대,QPC3365A,김혁규,金爀珪,열린우리당,비례대표,224,8,216,3,30,7,0,0,74,15,95,0,0,0,2,1,0,0,1,0,4,0,0,3,28,6,0,0,73,15,91,0,0
제17대,Z7A57920,손봉숙,孫鳳淑,새천년민주당,비례대표,214,29,185,8,17,3,0,0,76,11,99,0,0,1,0,0,0,0,11,0,17,0,0,7,17,3,0,0,65,11,82,0,0
제17대,SKV1971K,유선호,柳宣浩,열린우리당,"전라남도 장흥,영암군",272,10,262,5,34,5,0,0,70,12,146,0,0,0,0,0,0,0,3,2,5,0,0,5,34,5,0,0,67,10,141,0,0
제17대,QM028409,이강래,李康來,열린우리당,"전라북도 남원시,순창군",135,6,129,6,12,3,0,0,44,7,63,0,0,0,2,1,0,0,1,0,2,0,0,6,10,2,0,0,43,7,61,0,0
제17대,6MT5042E,이인기,李仁基,한나라당,"경북 고령,성주군",1248,24,1224,45,103,19,1,0,322,89,669,0,0,1,3,0,0,0,9,1,10,0,0,44,100,19,1,0,313,88,659,0,0
제17대,PJ76653N,임태희,任太熙,한나라당,경기도 성남시분당구을,281,10,271,9,36,3,0,0,65,22,146,0,0,0,1,0,0,0,1,3,5,0,0,9,35,3,0,0,64,19,141,0,0
제17대,DGA8069B,최구식,崔球植,한나라당,경상남도 진주시,318,25,293,15,35,6,0,0,76,19,167,0,0,2,1,1,0,0,6,2,13,0,0,13,34,5,0,0,70,17,154,0,0
제17대,KOC6603F,김광원,金光元,한나라당,"경상북도 봉화,울진군",235,2,233,11,40,2,0,0,49,12,121,0,0,0,0,0,0,0,1,0,1,0,0,11,40,2,0,0,48,12,120,0,0
제17대,XTQ62716,박명광,朴明光,열린우리당,비례대표,344,13,331,9,36,2,0,0,107,17,173,0,0,0,1,0,0,0,4,0,8,0,0,9,35,2,0,0,103,17,165,0,0
제17대,A9233564,김희선,金希宣,열린우리당,서울특별시 동대문구갑,298,16,282,6,24,6,0,0,83,15,164,0,0,0,1,1,0,0,3,2,9,0,0,6,23,5,0,0,80,13,155,0,0
제17대,D019409S,서혜석,徐惠錫,열린우리당,비례대표,285,8,277,10,35,6,0,0,92,14,128,0,0,0,2,0,0,0,3,0,3,0,0,10,33,6,0,0,89,14,125,0,0
제17대,8TR5716Y,엄호성,嚴虎聲,한나라당,부산광역시 사하구갑,1821,82,1739,57,141,31,0,0,487,152,953,0,0,2,4,0,0,0,9,6,61,0,0,55,137,31,0,0,478,146,892,0,0
제17대,Q4G3261X,염동연,廉東淵,열린우리당,광주 서구,371,12,359,6,47,5,0,0,155,16,142,0,0,0,1,1,0,0,5,0,5,0,0,6,46,4,0,0,150,16,137,0,0
제17대,HQZ6238Q,이성구,李聲九,한나라당,비례대표,330,75,255,12,31,3,0,0,75,20,189,0,0,4,3,0,0,0,25,10,33,0,0,8,28,3,0,0,50,10,156,0,0
제17대,FEQ4857T,이승희,李承姬,새천년민주당,비례대표,81,4,77,1,3,1,0,0,31,4,41,0,0,1,0,0,0,0,1,0,2,0,0,0,3,1,0,0,30,4,39,0,0
제17대,3TF1550T,권영길,權永吉,민주노동당,경상남도 창원시을,446,12,434,12,16,5,0,0,108,44,261,0,0,0,0,0,0,0,2,0,10,0,0,12,16,5,0,0,106,44,251,0,0
제17대,81X5760Z,김양수,金陽秀,한나라당,경상남도 양산시,561,47,514,22,52,6,0,0,152,33,296,0,0,2,0,1,0,0,16,3,25,0,0,20,52,5,0,0,136,30,271,0,0
제17대,2XI97689,이종구,李鍾九,한나라당,서울특별시 강남구갑,192,7,185,8,27,1,0,0,35,19,102,0,0,0,1,0,0,0,2,0,4,0,0,8,26,1,0,0,33,19,98,0,0
제17대,FOH4263F,정덕구,鄭德龜,열린우리당,비례대표,67,0,67,6,9,0,0,0,19,3,30,0,0,0,0,0,0,0,0,0,0,0,0,6,9,0,0,0,19,3,30,0,0
제17대,ZA54991S,안민석,安敏錫,열린우리당,경기 오산시화성군,390,12,378,7,48,3,0,0,113,15,204,0,0,0,2,0,0,0,6,0,4,0,0,7,46,3,0,0,107,15,200,0,0
제17대,YE691699,이규택,李揆澤,한나라당,"경기 이천시,여주군",217,16,201,9,29,6,0,0,47,22,104,0,0,0,1,0,0,0,2,1,12,0,0,9,28,6,0,0,45,21,92,0,0
제17대,RLG4231U,이상득,李相得,한나라당,"경상북도 포항시남구,울릉군",242,2,240,12,33,3,0,0,70,20,104,0,0,0,0,0,0,0,0,0,2,0,0,12,33,3,0,0,70,20,102,0,0
제17대,WDR7061Y,이종걸,李鍾杰,열린우리당,경기도 안양시만안구,283,33,250,5,34,3,0,0,98,14,129,0,0,0,3,0,0,0,12,1,17,0,0,5,31,3,0,0,86,13,112,0,0
제17대,Y009633J,배기선,裵基善,열린우리당,경기도 부천시원미구을,272,5,267,3,35,0,0,0,78,13,143,0,0,0,0,0,0,0,0,1,4,0,0,3,35,0,0,0,78,12,139,0,0
제17대,MO52543L,변재일,卞在一,열린우리당,충청북도 청원군,215,10,205,4,27,2,0,0,62,9,111,0,0,0,1,0,0,0,2,0,7,0,0,4,26,2,0,0,60,9,104,0,0
제17대,TA88758O,백원우,白元宇,열린우리당,경기 시흥시,370,6,364,11,51,5,0,0,116,22,165,0,0,0,2,0,0,0,2,0,2,0,0,11,49,5,0,0,114,22,163,0,0
제17대,8FC9697X,유기홍,柳基洪,열린우리당,서울특별시 관악구갑,185,12,173,3,29,3,0,0,50,8,92,0,0,2,4,0,0,0,3,1,2,0,0,1,25,3,0,0,47,7,90,0,0
제17대,3ZR4438W,이인영,李仁榮,열린우리당,서울특별시 구로구갑,388,19,369,8,45,7,0,0,120,12,196,0,0,0,1,0,0,0,2,0,16,0,0,8,44,7,0,0,118,12,180,0,0
제17대,F7R8891K,박찬석,朴贊石,열린우리당,비례대표,295,7,288,5,29,4,0,0,81,18,158,0,0,0,0,0,0,0,2,1,4,0,0,5,29,4,0,0,79,17,154,0,0
제17대,CPX9210C,박찬숙,朴贊淑,한나라당,비례대표,670,72,598,19,65,14,0,0,192,44,336,0,0,1,5,0,0,0,14,6,46,0,0,18,60,14,0,0,178,38,290,0,0
제17대,KZA7680N,장경수,張炅秀,열린우리당,경기 안산시상록구갑,270,25,245,10,26,4,0,0,107,20,103,0,0,1,1,0,0,0,9,2,12,0,0,9,25,4,0,0,98,18,91,0,0
제17대,AUU8827S,정형근,鄭亨根,한나라당,"부산 북,강서구갑",183,48,135,6,30,6,0,0,42,6,93,0,0,0,2,2,0,0,14,1,29,0,0,6,28,4,0,0,28,5,64,0,0
제17대,0827740Q,노웅래,盧雄來,열린우리당,서울특별시 마포구갑,408,21,387,10,45,5,0,0,121,35,192,0,0,0,1,0,0,0,9,1,10,0,0,10,44,5,0,0,112,34,182,0,0
제17대,0767470D,이낙연,李洛淵,새천년민주당,"전라남도 함평,영광군",270,33,237,9,32,4,0,0,83,14,128,0,0,1,0,1,0,0,9,3,19,0,0,8,32,3,0,0,74,11,109,0,0
제17대,IWK63872,조배숙,趙培淑,열린우리당,전북 익산시을,202,12,190,6,27,2,0,0,66,11,90,0,0,1,1,0,0,0,4,0,6,0,0,5,26,2,0,0,62,11,84,0,0
제17대,KDB6892X,김덕규,金德圭,열린우리당,서울특별시 중랑구을,266,4,262,11,32,4,0,0,99,19,101,0,0,0,0,0,0,0,1,2,1,0,0,11,32,4,0,0,98,17,100,0,0
제17대,4MX3134T,김형오,金炯旿,한나라당,부산광역시 영도구,134,6,128,6,26,0,0,0,25,5,72,0,0,0,0,0,0,0,1,0,5,0,0,6,26,0,0,0,24,5,67,0,0
제17대,FGX4881A,심재철,沈在哲,한나라당,경기 안양시동안구을,605,50,555,16,57,11,0,0,160,47,314,0,0,0,0,0,0,0,6,3,41,0,0,16,57,11,0,0,154,44,273,0,0
제17대,FPX1564S,안홍준,安鴻俊,한나라당,경남 마산시회원구,358,19,339,14,47,8,0,0,97,31,161,0,0,2,3,0,0,0,10,1,3,0,0,12,44,8,0,0,87,30,158,0,0
제17대,NEF96536,이주호,李周浩,한나라당,비례대표,355,39,316,13,28,7,0,0,83,22,202,0,0,1,1,0,0,0,14,0,23,0,0,12,27,7,0,0,69,22,179,0,0
제17대,P9D91805,정봉주,鄭鳳株,열린우리당,서울특별시 노원구갑,347,19,328,9,41,6,0,0,116,20,155,0,0,0,4,1,0,0,5,1,8,0,0,9,37,5,0,0,111,19,147,0,0
제17대,K8Q3437F,최규식,崔奎植,열린우리당,서울특별시 강북구을,249,19,230,7,31,1,0,0,79,7,124,0,0,0,4,0,0,0,6,1,8,0,0,7,27,1,0,0,73,6,116,0,0
제17대,2LX5217V,박계동,朴啓東,한나라당,서울특별시 송파구을,423,7,416,9,38,4,0,0,94,39,239,0,0,0,0,0,0,0,2,3,2,0,0,9,38,4,0,0,92,36,237,0,0
제17대,S8431719,박영선,朴映宣,열린우리당,비례대표,219,24,195,8,23,3,0,0,67,15,103,0,0,1,2,0,0,0,10,4,7,0,0,7,21,3,0,0,57,11,96,0,0
제17대,V1849655,정의화,鄭義和,한나라당,부산 중동구,320,10,310,19,34,4,0,0,67,22,174,0,0,2,0,1,0,0,4,0,3,0,0,17,34,3,0,0,63,22,171,0,0
제17대,GCA42857,주승용,朱昇鎔,열린우리당,전남 여수시을,424,36,388,21,58,13,0,0,159,21,152,0,0,4,1,0,0,0,15,4,12,0,0,17,57,13,0,0,144,17,140,0,0
제17대,G523339H,심재덕,沈載德,열린우리당,경기도 수원시장안구,542,14,528,17,62,6,0,0,177,42,238,0,0,0,0,0,0,0,6,0,8,0,0,17,62,6,0,0,171,42,230,0,0
제17대,26N9259T,이화영,李華泳,열린우리당,서울특별시 중랑구갑,186,3,183,3,21,2,0,0,60,7,93,0,0,0,0,0,0,0,2,0,1,0,0,3,21,2,0,0,58,7,92,0,0
제17대,1EL35837,원희룡,元喜龍,한나라당,서울특별시 양천구갑,157,6,151,8,24,2,0,0,43,9,71,0,0,0,0,1,0,0,1,1,3,0,0,8,24,1,0,0,42,8,68,0,0
제17대,F5E4993M,이은영,李銀榮,열린우리당,비례대표,358,25,333,5,40,4,0,0,109,19,181,0,0,0,1,2,0,0,3,1,18,0,0,5,39,2,0,0,106,18,163,0,0
제17대,KFP7066Z,이호웅,李浩雄,열린우리당,인천광역시 남동구을,219,27,192,7,28,5,0,0,79,17,83,0,0,1,3,3,0,0,12,2,6,0,0,6,25,2,0,0,67,15,77,0,0
제17대,T7P49316,천영세,千永世,민주노동당,비례대표,451,16,435,13,17,5,0,0,109,38,269,0,0,0,0,0,0,0,2,2,12,0,0,13,17,5,0,0,107,36,257,0,0
제17대,2ML68608,강성종,康聖鐘,열린우리당,경기 의정부시을,111,12,99,0,18,2,0,0,29,6,56,0,0,0,0,0,0,0,2,0,10,0,0,0,18,2,0,0,27,6,46,0,0
제17대,NHU2547U,양형일,梁亨一,열린우리당,광주광역시 동구,375,18,357,14,51,7,0,0,127,12,164,0,0,1,4,0,0,0,2,0,11,0,0,13,47,7,0,0,125,12,153,0,0
제17대,AB85417F,김송자,金松子,민주당,비례대표,65,0,65,1,9,0,0,0,14,0,41,0,0,0,0,0,0,0,0,0,0,0,0,1,9,0,0,0,14,0,41,0,0
제17대,X316937B,김정권,金正權,한나라당,경남 김해시갑,456,12,444,13,46,4,0,0,80,20,293,0,0,0,1,0,0,0,2,1,8,0,0,13,45,4,0,0,78,19,285,0,0
제17대,OK55632O,오영식,吳泳食,열린우리당,서울특별시 강북구갑,225,16,209,6,40,4,0,0,87,8,80,0,0,1,8,0,0,0,5,0,2,0,0,5,32,4,0,0,82,8,78,0,0
제17대,21B8160Y,이광철,李光喆,열린우리당,전북 전주시완산구,455,18,437,14,49,4,0,0,125,26,237,0,0,0,2,0,0,0,5,1,10,0,0,14,47,4,0,0,120,25,227,0,0
제17대,NBF6548X,조승수,趙承洙,민주노동당,울산광역시 북구,226,23,203,11,11,1,0,0,58,31,114,0,0,0,0,0,0,0,3,1,19,0,0,11,11,1,0,0,55,30,95,0,0
제17대,I553607U,최순영,崔順永,민주노동당,비례대표,522,31,491,13,29,4,0,0,135,43,298,0,0,0,0,0,0,0,4,1,26,0,0,13,29,4,0,0,131,42,272,0,0
제17대,XQ98168F,강길부,姜吉夫,열린우리당,울산광역시 울주군,304,23,281,13,47,6,0,0,72,9,157,0,0,0,2,2,0,0,3,0,16,0,0,13,45,4,0,0,69,9,141,0,0
제17대,RVR78866,김문수,金文洙,한나라당,경기도 부천시소사구,143,6,137,1,12,2,0,0,35,19,74,0,0,0,0,0,0,0,3,0,3,0,0,1,12,2,0,0,32,19,71,0,0
제17대,MXF7830L,신중식,申仲植,열린우리당,전남 고흥군,624,10,614,16,78,6,0,0,225,41,258,0,0,1,3,0,0,0,3,0,3,0,0,15,75,6,0,0,222,41,255,0,0
제17대,V822582Y,이목희,李穆熙,열린우리당,서울특별시 금천구,323,14,309,10,54,5,0,0,105,14,135,0,0,0,6,1,0,0,2,1,4,0,0,10,48,4,0,0,103,13,131,0,0
제17대,NET6850O,이윤성,李允盛,한나라당,인천광역시 남동구갑,411,21,390,14,44,8,0,0,107,36,202,0,0,4,3,0,0,0,6,0,8,0,0,10,41,8,0,0,101,36,194,0,0
제17대,RVD1966C,이해봉,李海鳳,한나라당,대구광역시 달서구을,995,10,985,43,84,17,0,0,292,74,485,0,0,0,0,0,0,0,2,2,6,0,0,43,84,17,0,0,290,72,479,0,0
제17대,39938231,정문헌,鄭文憲,한나라당,"강원 속초시,고성군,양양군",488,11,477,19,44,7,1,0,135,34,248,0,0,0,0,0,0,0,3,0,8,0,0,19,44,7,1,0,132,34,240,0,0
제17대,V8Y41572,서갑원,徐甲源,열린우리당,전라남도 순천시,346,20,326,9,55,1,0,0,110,16,155,0,0,1,9,0,0,0,5,0,5,0,0,8,46,1,0,0,105,16,150,0,0
제17대,OKK31241,서재관,徐載寬,열린우리당,충청북도 제천시단양군,427,17,410,11,44,7,0,0,151,26,188,0,0,1,2,0,0,0,7,0,7,0,0,10,42,7,0,0,144,26,181,0,0
제17대,99J1216Q,공성진,孔星鎭,한나라당,서울특별시 강남구을,393,21,372,12,40,6,0,0,94,26,215,0,0,1,1,0,0,0,5,1,13,0,0,11,39,6,0,0,89,25,202,0,0
제17대,37Q5759R,이영호,李泳鎬,열린우리당,"전라남도 강진,완도군",457,41,416,8,58,6,0,0,141,27,217,0,0,0,5,0,0,0,12,3,21,0,0,8,53,6,0,0,129,24,196,0,0
제17대,2GM8059R,박창달,朴昌達,한나라당,,59,0,59,1,4,2,0,0,21,0,31,0,0,0,0,0,0,0,0,0,0,0,0,1,4,2,0,0,21,0,31,0,0
제17대,UWS28633,임채정,林采正,열린우리당,서울 노원구병,52,1,51,1,4,1,0,0,28,1,17,0,0,0,0,0,0,0,1,0,0,0,0,1,4,1,0,0,27,1,17,0,0
제17대,5YX7831C,정몽준,鄭夢準,국민통합21,울산광역시 동구,103,3,100,6,23,1,0,0,27,6,40,0,0,0,0,0,0,0,0,0,3,0,0,6,23,1,0,0,27,6,37,0,0
제17대,1ZF7922T,김한길,金한길,열린우리당,서울 광진구갑,110,5,105,4,13,3,0,0,36,10,44,0,0,0,0,0,0,0,3,0,2,0,0,4,13,3,0,0,33,10,42,0,0
제17대,3ZP1685J,박기춘,朴起春,열린우리당,경기 남양주시을,397,15,382,14,56,2,0,0,112,30,183,0,0,2,6,0,0,0,3,0,4,0,0,12,50,2,0,0,109,30,179,0,0
제17대,GYW4323N,홍창선,洪昌善,열린우리당,비례대표,165,6,159,5,21,4,0,0,50,12,73,0,0,0,2,0,0,0,4,0,0,0,0,5,19,4,0,0,46,12,73,0,0
제17대,CNP7535A,이상열,李相烈,새천년민주당,전라남도 목포시,224,16,208,7,31,4,0,0,62,13,107,0,0,1,2,0,0,0,4,1,8,0,0,6,29,4,0,0,58,12,99,0,0
제17대,RE32613N,조순형,趙舜衡,민주당,서울 성북구을,9,0,9,0,4,0,0,0,4,0,1,0,0,0,0,0,0,0,0,0,0,0,0,0,4,0,0,0,4,0,1,0,0
제17대,QFQ8496R,이재창,李在昌,한나라당,경기도 파주시,146,13,133,6,28,2,0,0,25,12,73,0,0,0,0,2,0,0,3,4,4,0,0,6,28,0,0,0,22,8,69,0,0
제17대,5KV82250,조경태,趙慶泰,열린우리당,부산광역시 사하구을,368,13,355,14,41,7,0,0,135,29,142,0,0,2,1,2,0,0,6,0,2,0,0,12,40,5,0,0,129,29,140,0,0
제17대,N3Q3468A,김우남,金宇南,열린우리당,제주 북제주군을,443,27,416,14,56,6,0,0,146,23,198,0,0,0,3,0,0,0,15,1,8,0,0,14,53,6,0,0,131,22,190,0,0
제17대,E5N8503B,김종인,金鍾仁,새천년민주당,비례대표,55,0,55,0,3,1,0,0,14,2,35,0,0,0,0,0,0,0,0,0,0,0,0,0,3,1,0,0,14,2,35,0,0
제17대,D0K32445,이계진,李季振,한나라당,강원도 원주시,377,14,363,8,39,6,0,0,88,25,211,0,0,0,0,0,0,0,2,1,11,0,0,8,39,6,0,0,86,24,200,0,0
제17대,PTC64957,정진섭,鄭鎭燮,한나라당,경기 광주시,151,4,147,8,26,3,0,0,25,11,78,0,0,0,0,0,0,0,0,0,4,0,0,8,26,3,0,0,25,11,74,0,0
제17대,JPE16970,박재완,朴宰完,한나라당,비례대표,1108,76,1032,30,95,20,0,0,313,92,558,0,0,1,0,3,0,0,15,9,48,0,0,29,95,17,0,0,298,83,510,0,0
제17대,IH33403A,안영근,安泳根,열린우리당,인천광역시 남구을,149,5,144,3,15,2,0,0,43,6,80,0,0,0,0,0,0,0,2,1,2,0,0,3,15,2,0,0,41,5,78,0,0
제17대,OGA6675L,박형준,朴亨埈,한나라당,부산광역시 수영구,442,17,425,23,42,7,1,0,114,33,222,0,0,0,1,1,0,0,8,3,4,0,0,23,41,6,1,0,106,30,218,0,0
제17대,PAO22428,송영길,宋永吉,열린우리당,인천 계양구을,334,28,306,10,41,8,0,0,100,27,148,0,0,0,2,0,0,0,6,1,19,0,0,10,39,8,0,0,94,26,129,0,0
제17대,8G72444I,이시종,李始鍾,열린우리당,충청북도 충주시,616,26,590,17,83,8,1,0,207,42,258,0,0,0,6,1,0,0,6,0,13,0,0,17,77,7,1,0,201,42,245,0,0
제17대,53Y1887H,최규성,崔圭成,열린우리당,"전북 김제시,완주군",349,9,340,14,53,3,0,0,120,13,146,0,0,0,5,0,0,0,1,0,3,0,0,14,48,3,0,0,119,13,143,0,0
제17대,L4F3519L,한광원,韓光元,열린우리당,"인천광역시 중,동구,옹진군",516,18,498,11,63,6,0,0,157,27,252,0,0,0,3,0,0,0,5,2,8,0,0,11,60,6,0,0,152,25,244,0,0
제17대,7TU84910,한화갑,韓和甲,새천년민주당,"전라남도 무안,신안군",116,3,113,3,13,2,0,0,44,7,47,0,0,1,0,0,0,0,2,0,0,0,0,2,13,2,0,0,42,7,47,0,0
제17대,DYN10119,김성조,金晟祚,한나라당,경북 구미시,280,18,262,9,38,3,0,0,61,11,158,0,0,0,0,0,0,0,5,1,12,0,0,9,38,3,0,0,56,10,146,0,0
제17대,9XB6464U,김현미,金賢美,열린우리당,비례대표,240,13,227,6,30,6,0,0,73,8,117,0,0,0,3,2,0,0,4,0,4,0,0,6,27,4,0,0,69,8,113,0,0
제17대,PHE6239O,송영선,宋永仙,한나라당,비례대표,205,13,192,7,27,2,0,0,43,14,112,0,0,0,0,0,0,0,3,0,10,0,0,7,27,2,0,0,40,14,102,0,0
제17대,9BE5694R,유승희,兪承希,열린우리당,비례대표,337,20,317,9,36,2,0,0,113,15,162,0,0,0,1,0,0,0,6,0,13,0,0,9,35,2,0,0,107,15,149,0,0
제17대,FP331081,이기우,李基宇,열린우리당,경기도 수원시권선구,223,20,203,2,29,2,0,0,75,14,101,0,0,2,3,0,0,0,5,2,8,0,0,0,26,2,0,0,70,12,93,0,0
제17대,DCN7433W,정세균,丁世均,열린우리당,"전북 진안,무주,장수군,임실군",57,3,54,0,12,1,0,0,20,2,22,0,0,0,3,0,0,0,0,0,0,0,0,0,9,1,0,0,20,2,22,0,0
제17대,ZAD6422F,허천,,한나라당,강원도 춘천시,255,8,247,12,34,4,0,0,76,17,112,0,0,1,0,0,0,0,4,1,2,0,0,11,34,4,0,0,72,16,110,0,0
제17대,0W194007,김영주,金榮珠,열린우리당,비례대표,329,22,307,7,49,8,0,0,123,14,128,0,0,0,6,0,0,0,7,0,9,0,0,7,43,8,0,0,116,14,119,0,0
제17대,X7K8338U,박성범,朴成範,한나라당,서울특별시 중구,232,15,217,13,24,8,0,0,61,8,118,0,0,0,1,0,0,0,5,1,8,0,0,13,23,8,0,0,56,7,110,0,0
제17대,BVE2865R,김명주,金命柱,한나라당,"경상남도 통영시,고성군",560,16,544,17,72,9,0,0,161,30,271,0,0,0,4,1,0,0,8,0,3,0,0,17,68,8,0,0,153,30,268,0,0
제17대,2Z21631Z,최재천,崔載千,열린우리당,서울 성동구갑,147,20,127,2,14,7,0,0,42,7,75,0,0,0,1,2,0,0,3,1,13,0,0,2,13,5,0,0,39,6,62,0,0
제17대,5PS66776,맹형규,孟亨奎,한나라당,서울특별시 송파구갑,226,21,205,10,26,6,0,0,51,11,122,0,0,1,2,0,0,0,7,0,11,0,0,9,24,6,0,0,44,11,111,0,0
제17대,M0A1658U,윤호중,尹昊重,열린우리당,경기도 구리시,324,12,312,9,37,7,0,0,106,11,154,0,0,1,2,0,0,0,5,0,4,0,0,8,35,7,0,0,101,11,150,0,0
제17대,KXZ3061M,이근식,李根植,열린우리당,서울특별시 송파구병,543,16,527,15,63,6,0,0,180,42,237,0,0,0,1,1,0,0,4,0,10,0,0,15,62,5,0,0,176,42,227,0,0
제17대,CSB26402,고조흥,高照興,한나라당,"경기 연천군,포천군",647,12,635,14,54,12,0,0,135,54,378,0,0,0,0,0,0,0,1,1,10,0,0,14,54,12,0,0,134,53,368,0,0
제17대,M3Z17237,김재경,金在庚,한나라당,경남 진주시을,492,11,481,14,66,4,0,0,137,36,235,0,0,0,0,0,0,0,5,0,6,0,0,14,66,4,0,0,132,36,229,0,0
제17대,PU35479A,이정일,李正一,새천년민주당,"전남 해남,진도군",139,0,139,4,26,3,0,0,45,8,53,0,0,0,0,0,0,0,0,0,0,0,0,4,26,3,0,0,45,8,53,0,0
제17대,GKV4796M,정장선,鄭長善,열린우리당,경기 평택시을,338,19,319,7,42,4,0,0,122,14,149,0,0,0,5,0,0,0,6,1,7,0,0,7,37,4,0,0,116,13,142,0,0
제17대,54B18425,차명진,車明進,한나라당,경기 부천시소사구,177,12,165,9,23,0,0,0,24,12,109,0,0,0,0,0,0,0,3,2,7,0,0,9,23,0,0,0,21,10,102,0,0
제17대,DCR84445,김동철,金東喆,열린우리당,광주광역시 광산구,445,41,404,14,57,6,0,0,150,15,203,0,0,2,2,1,0,0,16,0,20,0,0,12,55,5,0,0,134,15,183,0,0
제17대,Q3X5279D,윤두환,尹斗煥,한나라당,울산 북구,163,20,143,11,31,4,0,0,27,7,83,0,0,0,4,0,0,0,6,2,8,0,0,11,27,4,0,0,21,5,75,0,0
제17대,MFX9451F,이경숙,李景淑,열린우리당,비례대표,334,31,303,11,42,2,0,0,109,9,161,0,0,2,3,0,0,0,10,1,15,0,0,9,39,2,0,0,99,8,146,0,0
제17대,F0P9129B,이원영,李源榮,열린우리당,경기 광명시갑,382,11,371,8,38,9,0,0,130,30,167,0,0,0,1,0,0,0,1,2,7,0,0,8,37,9,0,0,129,28,160,0,0
제17대,34Y32105,임해규,林亥圭,한나라당,경기 부천시원미구갑,214,12,202,10,24,5,0,0,42,10,123,0,0,0,0,2,0,0,2,0,8,0,0,10,24,3,0,0,40,10,115,0,0
제17대,L3X8851C,최인기,崔仁基,무소속,전남 나주시,525,21,504,13,57,6,0,0,185,35,229,0,0,0,3,0,0,0,10,0,8,0,0,13,54,6,0,0,175,35,221,0,0
제17대,7PU7009N,강봉균,康奉均,열린우리당,전라북도 군산시,67,2,65,3,11,0,0,0,27,3,23,0,0,0,0,0,0,0,2,0,0,0,0,3,11,0,0,0,25,3,23,0,0
제17대,UIN2835Q,김효석,金孝錫,새천년민주당,"전라남도 담양,곡성,장성군",262,42,220,5,33,4,0,0,99,17,104,0,0,1,3,1,0,0,16,11,10,0,0,4,30,3,0,0,83,6,94,0,0
제17대,ARF1960L,현애자,玄愛子,민주노동당,비례대표,478,34,444,12,20,5,0,0,120,44,277,0,0,1,1,0,0,0,13,1,18,0,0,11,19,5,0,0,107,43,259,0,0
제17대,PMU9608V,김태환,金泰煥,한나라당,경북 구미시을,404,8,396,11,47,4,0,0,106,20,216,0,0,0,2,0,0,0,3,1,2,0,0,11,45,4,0,0,103,19,214,0,0
제17대,63J3777V,유정복,劉正福,한나라당,경기도 김포시,336,20,316,10,37,5,1,0,88,39,156,0,0,0,1,0,0,0,4,0,15,0,0,10,36,5,1,0,84,39,141,0,0
제17대,1WE5693J,김태년,金太年,열린우리당,경기도 성남시수정구,793,17,776,14,88,9,0,0,231,53,398,0,0,1,6,0,0,0,2,1,7,0,0,13,82,9,0,0,229,52,391,0,0
제17대,7XG93147,이상락,李相樂,열린우리당,경기도 성남시중원구,102,1,101,3,13,2,0,0,41,8,35,0,0,0,0,0,0,0,0,1,0,0,0,3,13,2,0,0,41,7,35,0,0
제17대,XGQ9659R,이한구,李漢久,한나라당,대구광역시 수성구갑,146,13,133,7,24,1,0,0,27,4,83,0,0,0,1,0,0,0,4,0,8,0,0,7,23,1,0,0,23,4,75,0,0
제17대,X6I1342Z,김낙순,金洛淳,열린우리당,서울특별시 양천구을,264,10,254,5,37,6,0,0,91,10,115,0,0,0,2,1,0,0,3,0,4,0,0,5,35,5,0,0,88,10,111,0,0
제17대,TWL5801D,김영춘,金榮春,열린우리당,서울특별시 광진구갑,363,20,343,8,38,7,0,0,122,27,161,0,0,0,0,1,0,0,6,1,12,0,0,8,38,6,0,0,116,26,149,0,0
제17대,YLM92014,박순자,朴順子,한나라당,비례대표,354,12,342,16,49,11,1,0,84,25,168,0,0,2,1,0,0,0,2,4,3,0,0,14,48,11,1,0,82,21,165,0,0
제17대,CT85313K,서병수,徐秉洙,한나라당,부산광역시 해운대구 기장군갑,427,24,403,11,47,6,0,0,92,38,233,0,0,0,0,1,0,0,2,2,19,0,0,11,47,5,0,0,90,36,214,0,0
제17대,R7753197,우윤근,禹潤根,열린우리당,"전라남도 광양시,구례군",379,20,359,15,44,7,0,0,125,17,171,0,0,2,4,0,0,0,7,1,6,0,0,13,40,7,0,0,118,16,165,0,0
제17대,CAL85655,유기준,兪奇濬,한나라당,부산광역시 서구,608,34,574,13,51,13,0,0,144,41,346,0,0,0,0,0,0,0,6,1,27,0,0,13,51,13,0,0,138,40,319,0,0
제17대,EBU8493R,이미경,李美卿,열린우리당,서울 은평구갑,348,11,337,9,43,3,0,0,102,11,180,0,0,0,1,0,0,0,1,0,9,0,0,9,42,3,0,0,101,11,171,0,0
제17대,8SV6917G,주호영,朱豪英,한나라당,대구광역시 수성구을,251,13,238,7,37,3,1,0,43,14,146,0,0,0,0,0,0,0,2,0,11,0,0,7,37,3,1,0,41,14,135,0,0
제17대,9A03059M,고진화,高鎭和,한나라당,서울특별시 영등포구갑,235,14,221,9,31,2,0,0,69,19,105,0,0,0,1,1,0,0,6,0,6,0,0,9,30,1,0,0,63,19,99,0,0
제17대,X1K3667J,김교흥,金敎興,열린우리당,인천광역시 서구강화군갑,340,19,321,11,57,7,0,0,101,20,144,0,0,0,6,1,0,0,7,4,1,0,0,11,51,6,0,0,94,16,143,0,0
제17대,GD131760,홍문표,洪文杓,한나라당,충남 예산군,219,17,202,9,34,2,0,0,59,14,101,0,0,0,3,0,0,0,4,1,9,0,0,9,31,2,0,0,55,13,92,0,0
제17대,PJB6652Y,임종석,任鍾晳,열린우리당,서울 성동구을,285,4,281,9,32,4,0,0,94,12,134,0,0,0,1,0,0,0,1,1,1,0,0,9,31,4,0,0,93,11,133,0,0
제17대,R403874L,제종길,諸淙吉,열린우리당,경기 안산시단원구을,404,18,386,12,60,6,0,0,139,23,164,0,0,3,4,1,0,0,5,4,1,0,0,9,56,5,0,0,134,19,163,0,0
제17대,X0R95148,강기갑,姜基甲,민주노동당,비례대표,475,32,443,12,26,8,0,0,110,44,275,0,0,0,0,0,0,0,11,3,18,0,0,12,26,8,0,0,99,41,257,0,0
제17대,OWQ6217E,이상경,李相庚,열린우리당,서울특별시 강동구을,338,25,313,10,41,4,0,0,95,25,163,0,0,1,1,0,0,0,7,0,16,0,0,9,40,4,0,0,88,25,147,0,0
제17대,U0H3584N,박세일,朴世逸,한나라당,비례(한) 비례(한나라당),4,0,4,1,1,0,0,0,2,0,0,0,0,0,0,0,0,0,0,0,0,0,0,1,1,0,0,0,2,0,0,0,0
제17대,SJ050998,신명,,열린우리당,비례대표,126,30,96,4,9,0,0,0,22,4,87,0,0,0,4,0,0,0,8,1,17,0,0,4,5,0,0,0,14,3,70,0,0
제17대,NG55346W,전병헌,田炳憲,열린우리당,서울특별시 동작구갑,212,21,191,4,23,1,0,0,65,18,101,0,0,2,3,0,0,0,7,3,6,0,0,2,20,1,0,0,58,15,95,0,0
제17대,PYP5878A,한명숙,韓明淑,열린우리당,경기 고양시일산구갑,147,5,142,6,21,6,0,0,50,7,57,0,0,0,0,0,0,0,0,0,5,0,0,6,21,6,0,0,50,7,52,0,0
제17대,I4W1829R,김애실,金愛實,한나라당,비례대표,442,31,411,17,48,3,0,0,111,43,220,0,0,1,0,0,0,0,10,5,15,0,0,16,48,3,0,0,101,38,205,0,0
제17대,95C2897K,김홍업,金弘業,민주당,"전남 무안군,신안군",44,2,42,1,5,0,0,0,7,0,31,0,0,0,0,0,0,0,0,0,2,0,0,1,5,0,0,0,7,0,29,0,0
제17대,IYD4143Y,문희상,文喜相,열린우리당,경기 의정부시,78,4,74,1,8,0,0,0,19,1,49,0,0,0,0,0,0,0,2,0,2,0,0,1,8,0,0,0,17,1,47,0,0
제17대,WXJ8352N,이성권,李成權,한나라당,부산광역시 부산진구을,749,57,692,39,68,9,0,0,209,58,366,0,0,5,8,0,0,0,15,3,26,0,0,34,60,9,0,0,194,55,340,0,0
제17대,8NC1161S,임인배,林仁培,한나라당,경북 김천시,322,27,295,12,38,6,0,0,80,22,164,0,0,2,2,0,0,0,6,2,15,0,0,10,36,6,0,0,74,20,149,0,0
제17대,YKA9050K,홍재형,洪在馨,열린우리당,충북 청주시상당구,111,8,103,3,13,2,0,0,35,7,51,0,0,0,0,0,0,0,2,1,5,0,0,3,13,2,0,0,33,6,46,0,0
제17대,6A77393C,김명자,金明子,열린우리당,비례대표,254,11,243,10,30,3,0,0,79,8,124,0,0,2,2,0,0,0,4,0,3,0,0,8,28,3,0,0,75,8,121,0,0
제17대,LBC8144B,김영선,金映宣,한나라당,경기 고양시일산서구,230,18,212,9,23,6,0,0,61,21,110,0,0,0,0,0,0,0,4,0,14,0,0,9,23,6,0,0,57,21,96,0,0
제17대,AI14411Y,심재엽,沈在曄,한나라당,강원도 강릉시,234,20,214,9,37,2,0,0,71,20,95,0,0,2,1,0,0,0,8,2,7,0,0,7,36,2,0,0,63,18,88,0,0
제17대,P5N77987,오시덕,吳施德,열린우리당,"충청남도 공주시,연기군",78,1,77,3,14,1,0,0,31,6,23,0,0,1,0,0,0,0,0,0,0,0,0,2,14,1,0,0,31,6,23,0,0
제17대,H6577987,이경재,李敬在,한나라당,인천광역시 서구강화군을,346,14,332,13,41,5,0,0,80,19,188,0,0,0,0,0,0,0,7,1,6,0,0,13,41,5,0,0,73,18,182,0,0
제17대,VTN3694W,정동채,鄭東采,열린우리당,광주 서구을,119,2,117,1,13,0,0,0,46,4,55,0,0,0,0,0,0,0,0,0,2,0,0,1,13,0,0,0,46,4,53,0,0
제17대,JGX8852O,고흥길,高興吉,한나라당,경기도 성남시분당구갑,224,7,217,7,33,4,1,0,52,21,106,0,0,0,1,0,0,0,1,2,3,0,0,7,32,4,1,0,51,19,103,0,0
제17대,KDL4367Q,김학송,金鶴松,한나라당,경상남도 진해시,282,13,269,12,33,5,0,0,81,26,125,0,0,1,1,0,0,0,4,1,6,0,0,11,32,5,0,0,77,25,119,0,0
제17대,44936542,박종근,朴鍾根,한나라당,대구광역시 달서구갑,171,5,166,7,27,6,0,0,42,11,78,0,0,0,0,0,0,0,2,0,3,0,0,7,27,6,0,0,40,11,75,0,0
제17대,XFH9918T,유시민,柳時敏,열린우리당,경기도 고양시덕양구갑,179,8,171,7,22,1,0,0,65,15,69,0,0,0,0,0,0,0,1,1,6,0,0,7,22,1,0,0,64,14,63,0,0
제17대,TQS1780I,윤원호,尹元昊,열린우리당,비례대표,323,15,308,8,35,2,0,0,106,12,160,0,0,0,0,0,0,0,7,0,8,0,0,8,35,2,0,0,99,12,152,0,0
제17대,BU250813,이계안,李啓安,열린우리당,서울특별시 동작구을,232,22,210,8,31,4,0,0,76,11,102,0,0,0,2,0,0,0,6,1,13,0,0,8,29,4,0,0,70,10,89,0,0
제17대,04H1337G,이명규,李明奎,한나라당,대구광역시 북구갑,445,50,395,17,59,8,0,0,98,26,237,0,0,3,7,0,0,0,15,7,18,0,0,14,52,8,0,0,83,19,219,0,0
제17대,F1M3009R,김형주,金炯柱,열린우리당,서울특별시 광진구을,329,7,322,5,52,5,0,0,111,14,142,0,0,1,2,0,0,0,2,0,2,0,0,4,50,5,0,0,109,14,140,0,0
제17대,E6S86397,박승환,朴勝煥,한나라당,부산광역시 금정구,324,20,304,9,41,5,0,0,109,23,137,0,0,0,3,0,0,0,11,1,5,0,0,9,38,5,0,0,98,22,132,0,0
제17대,LG63087O,권영세,權寧世,한나라당,서울특별시 영등포구을,212,15,197,9,25,7,0,0,54,15,102,0,0,0,1,1,0,0,3,2,8,0,0,9,24,6,0,0,51,13,94,0,0
제17대,L808164D,조성래,趙誠來,열린우리당,비례대표,312,11,301,9,34,6,0,0,93,12,158,0,0,1,0,0,0,0,1,0,9,0,0,8,34,6,0,0,92,12,149,0,0
제17대,HRG9655C,김희정,金姬廷,한나라당,부산광역시 연제구,330,18,312,30,35,2,0,0,87,24,152,0,0,0,0,0,0,0,7,0,11,0,0,30,35,2,0,0,80,24,141,0,0
제17대,4HB8518T,박근혜,朴槿惠,한나라당,대구 달성군,69,4,65,6,19,0,0,0,11,1,32,0,0,0,0,0,0,0,2,0,2,0,0,6,19,0,0,0,9,1,30,0,0
제17대,ZF959220,안경률,安炅律,한나라당,부산광역시 해운대구 기장군을,306,15,291,9,32,8,0,0,62,26,169,0,0,0,2,0,0,0,4,2,7,0,0,9,30,8,0,0,58,24,162,0,0
제17대,ZO74670Y,이철우,李哲禹,열린우리당,"경기 연천군,포천군",137,4,133,3,14,1,0,0,60,11,48,0,0,0,0,0,0,0,2,1,1,0,0,3,14,1,0,0,58,10,47,0,0
제17대,VTB9705E,장복심,張福心,열린우리당,비례대표,655,42,613,20,88,6,0,0,195,36,310,0,0,0,5,0,0,0,13,4,20,0,0,20,83,6,0,0,182,32,290,0,0
제17대,IN328264,조정식,趙正湜,열린우리당,경기 시흥시을,214,14,200,7,36,2,0,0,78,11,80,0,0,0,2,0,0,0,9,3,0,0,0,7,34,2,0,0,69,8,80,0,0
제17대,1PK82111,강기정,姜琪正,열린우리당,광주광역시 북구갑,470,24,446,10,53,7,0,0,163,21,216,0,0,0,5,2,0,0,11,0,6,0,0,10,48,5,0,0,152,21,210,0,0
제17대,X7I4680R,김기현,金起炫,한나라당,울산 남구을,373,38,335,10,43,4,0,0,109,26,181,0,0,0,3,0,0,0,13,0,22,0,0,10,40,4,0,0,96,26,159,0,0
제17대,N467888G,채일병,蔡日炳,민주당,"전남 해남군,진도군",110,6,104,2,14,0,0,0,16,3,75,0,0,0,0,0,0,0,2,0,4,0,0,2,14,0,0,0,14,3,71,0,0
제17대,ZX71333R,한선교,韓善敎,한나라당,경기도 용인시을,291,48,243,11,38,3,0,0,64,27,148,0,0,0,2,0,0,0,13,5,28,0,0,11,36,3,0,0,51,22,120,0,0
제17대,AV73550N,이상배,李相培,한나라당,경상북도 상주시,348,24,324,13,48,5,0,0,102,26,154,0,0,0,1,1,0,0,5,2,15,0,0,13,47,4,0,0,97,24,139,0,0
제17대,GMK1374L,이석현,李錫玄,열린우리당,경기 안양시동안구,124,6,118,4,14,1,0,0,41,9,55,0,0,1,1,0,0,0,2,0,2,0,0,3,13,1,0,0,39,9,53,0,0
제17대,LCJ77278,이혜훈,李惠薰,한나라당,서울특별시 서초구갑,560,42,518,14,54,11,0,0,145,46,290,0,0,0,1,2,0,0,12,9,18,0,0,14,53,9,0,0,133,37,272,0,0
제17대,N151609U,지병문,池秉文,열린우리당,광주광역시 남구,298,17,281,14,44,3,0,0,102,7,128,0,0,0,3,0,0,0,6,0,8,0,0,14,41,3,0,0,96,7,120,0,0
제17대,UIZ3103R,김부겸,金富謙,열린우리당,경기도 군포시,208,8,200,6,29,0,0,0,59,16,98,0,0,0,0,0,0,0,1,0,7,0,0,6,29,0,0,0,58,16,91,0,0
제17대,71M8132V,신상진,申相珍,한나라당,경기 성남시중원구,956,29,927,37,67,11,0,0,213,60,568,0,0,0,2,0,0,0,6,6,15,0,0,37,65,11,0,0,207,54,553,0,0
제17대,H059875B,단병호,段炳浩,민주노동당,비례대표,462,40,422,15,27,4,0,0,118,44,254,0,0,0,3,0,0,0,10,19,8,0,0,15,24,4,0,0,108,25,246,0,0
제17대,S2C3781V,신계륜,申溪輪,열린우리당,서울특별시 성북구을,37,2,35,0,3,0,0,0,13,1,20,0,0,0,0,0,0,0,0,0,2,0,0,0,3,0,0,0,13,1,18,0,0
제17대,RRD80903,이덕모,李德模,한나라당,경상북도 영천시,14,3,11,0,2,0,0,0,9,2,1,0,0,0,1,0,0,0,2,0,0,0,0,0,1,0,0,0,7,2,1,0,0
제17대,EIV1009T,정두언,鄭斗彦,한나라당,서울특별시 서대문구을,360,14,346,12,55,7,0,0,95,34,157,0,0,1,1,0,0,0,4,2,6,0,0,11,54,7,0,0,91,32,151,0,0
제17대,V429892C,정성호,鄭成湖,열린우리당,"경기 양주,동두천시",860,73,787,14,91,12,0,0,298,66,379,0,0,1,7,2,0,0,26,8,29,0,0,13,84,10,0,0,272,58,350,0,0
제17대,3OA12807,권오을,權五乙,한나라당,경상북도 안동시,308,14,294,8,44,5,1,0,68,20,162,0,0,0,1,0,0,0,2,2,9,0,0,8,43,5,1,0,66,18,153,0,0
제17대,ZY76641C,김병호,金秉浩,한나라당,부산광역시 부산진구갑,160,13,147,4,6,4,0,0,58,21,67,0,0,0,1,1,0,0,4,2,5,0,0,4,5,3,0,0,54,19,62,0,0
제17대,EI023764,남경필,南景弼,한나라당,경기도 수원시팔달구,275,12,263,15,23,1,0,0,65,24,147,0,0,0,0,0,0,0,2,2,8,0,0,15,23,1,0,0,63,22,139,0,0
제17대,JR141579,정희수,鄭熙秀,한나라당,경북 영천시,253,10,243,7,33,6,0,0,55,16,136,0,0,0,0,0,0,0,2,0,8,0,0,7,33,6,0,0,53,16,128,0,0
제17대,OE127272,허태열,許泰烈,한나라당,"부산광역시 북,강서구을",316,20,296,11,38,11,1,0,91,21,143,0,0,1,2,2,0,0,7,1,7,0,0,10,36,9,1,0,84,20,136,0,0
제17대,CJ73668M,김석준,金錫俊,한나라당,대구 달서구병,645,74,571,32,63,6,0,0,175,64,305,0,0,18,3,0,0,0,14,3,36,0,0,14,60,6,0,0,161,61,269,0,0
제17대,G756492A,김재홍,金在洪,열린우리당,비례대표,332,10,322,7,38,3,0,0,111,12,161,0,0,0,2,0,0,0,3,0,5,0,0,7,36,3,0,0,108,12,156,0,0
제17대,OHW68320,윤건영,尹建永,한나라당,비례대표,426,35,391,17,39,3,0,0,97,39,231,0,0,0,2,0,0,0,12,3,18,0,0,17,37,3,0,0,85,36,213,0,0
제17대,SVO8520I,이재웅,李在雄,한나라당,부산광역시 동래구,301,13,288,10,40,6,0,0,49,21,175,0,0,0,0,0,0,0,5,1,7,0,0,10,40,6,0,0,44,20,168,0,0
제17대,VZ33903V,조성태,趙成台,열린우리당,비례대표,63,3,60,1,6,1,0,0,23,4,28,0,0,0,0,0,0,0,1,0,2,0,0,1,6,1,0,0,22,4,26,0,0
제17대,3O66539X,김성곤,金星坤,열린우리당,전라남도 여수시,335,12,323,9,35,2,0,0,95,16,178,0,0,1,2,0,0,0,3,1,5,0,0,8,33,2,0,0,92,15,173,0,0
제17대,XBT9550Q,우원식,禹元植,열린우리당,서울특별시 노원구을,331,22,309,11,48,7,0,0,111,15,139,0,0,2,3,0,0,0,8,3,6,0,0,9,45,7,0,0,103,12,133,0,0
제17대,D9R93445,이진구,李珍求,한나라당,충남 아산시,149,6,143,8,24,3,0,0,39,6,69,0,0,0,0,0,0,0,2,0,4,0,0,8,24,3,0,0,37,6,65,0,0
제17대,2385336L,정청래,鄭淸來,열린우리당,서울특별시 마포구을,481,21,460,12,48,9,0,0,140,23,249,0,0,1,1,0,0,0,5,2,12,0,0,11,47,9,0,0,135,21,237,0,0
제17대,8DY7297I,채수찬,蔡秀燦,열린우리당,전라북도 전주시덕진구,126,17,109,3,14,2,0,0,54,6,47,0,0,0,2,0,0,0,3,2,10,0,0,3,12,2,0,0,51,4,37,0,0
제17대,7W28547U,최용규,崔龍圭,열린우리당,인천 부평구을,128,14,114,1,19,6,0,0,44,3,55,0,0,0,3,1,0,0,3,0,7,0,0,1,16,5,0,0,41,3,48,0,0
제17대,VE469451,최재성,崔宰誠,열린우리당,경기 남양주시,295,19,276,5,50,8,0,0,76,20,136,0,0,1,3,0,0,0,2,1,12,0,0,4,47,8,0,0,74,19,124,0,0
제17대,Q5X4506F,황우여,黃祐呂,한나라당,인천 연수구,924,19,905,29,75,18,0,0,256,52,494,0,0,0,0,0,0,0,2,0,17,0,0,29,75,18,0,0,254,52,477,0,0
제17대,OKR39415,김원웅,金元雄,열린우리당,대전광역시 대덕구,269,11,258,3,26,4,0,0,91,12,133,0,0,0,1,0,0,0,2,1,7,0,0,3,25,4,0,0,89,11,126,0,0
제17대,39R30936,선병렬,宣炳烈,열린우리당,대전광역시 동구,423,38,385,11,54,10,0,0,121,20,207,0,0,2,2,0,0,0,12,1,21,0,0,9,52,10,0,0,109,19,186,0,0
