대수,국회의원코드,국회의원명,국회의원한자명,정당명,선거구명,발의수(전체),발의수(대표발의),발의수(공동발의),원안가결(전체),수정가결(전체),철회(전체),부결(전체),수정안반영폐기(전체),대안반영폐기(전체),폐기(전체),임기만료폐기(전체),회기불계속폐기(전체),기타(전체),원안가결(대표발의),수정가결(대표발의),철회(대표발의),부결(대표발의),수정안반영폐기(대표발의),대안반영폐기(대표발의),폐기(대표발의),임기만료폐기(대표발의),회기불계속폐기(대표발의),기타,원안가결(공동발의),수정가결(공동발의),철회(공동발의),부결(공동발의),수정안반영폐기(공동발의),대안반영폐기(공동발의),폐기(공동발의),임기만료폐기(공동발의),회기불계속폐기(공동발의),기타(공동발의)
제20대,6N28669V,서형수,徐炯洙,더불어민주당,경남 양산시을,1120,68,1052,18,46,6,0,1,264,4,781,0,0,1,2,0,0,0,8,0,57,0,0,17,44,6,0,1,256,4,724,0,0
제20대,I5V5327I,유민봉,庾敏鳳,새누리당,비례대표,525,27,498,8,25,3,0,1,112,3,373,0,0,0,3,0,0,0,5,0,19,0,0,8,22,3,0,1,107,3,354,0,0
제20대,6YT83269,이명수,李明洙,새누리당,충남 아산시갑,1267,215,1052,46,55,11,0,1,355,11,788,0,0,17,5,2,0,0,73,2,116,0,0,29,50,9,0,1,282,9,672,0,0
제20대,WDR7061Y,이종걸,李鍾杰,더불어민주당,경기 안양시만안구,1194,59,1135,20,39,11,0,6,191,9,918,0,0,1,0,1,0,0,4,0,53,0,0,19,39,10,0,6,187,9,865,0,0
제20대,AFQ26679,주광덕,朱光德,새누리당,경기 남양주시병,437,50,387,10,21,3,0,0,87,2,314,0,0,2,3,0,0,0,7,0,38,0,0,8,18,3,0,0,80,2,276,0,0
제20대,BQS2021C,김성태,金聖泰,새누리당,서울 강서구을,418,34,384,7,25,8,0,0,125,3,250,0,0,0,1,0,0,0,13,1,19,0,0,7,24,8,0,0,112,2,231,0,0
제20대,SLW27496,나경원,羅景垣,새누리당,서울 동작구을,320,42,278,11,19,2,0,0,63,1,224,0,0,3,0,0,0,0,7,0,32,0,0,8,19,2,0,0,56,1,192,0,0
제20대,9ZP9014Q,이해찬,李海瓚,무소속,세종특별자치시,273,10,263,6,11,4,0,0,52,4,196,0,0,0,2,0,0,0,2,1,5,0,0,6,9,4,0,0,50,3,191,0,0
제20대,1WE5693J,김태년,金太年,더불어민주당,경기 성남시수정구,468,30,438,12,21,8,0,1,109,3,314,0,0,0,1,0,0,0,8,0,21,0,0,12,20,8,0,1,101,3,293,0,0
제20대,FJK3396E,맹성규,孟聖奎,더불어민주당,인천 남동구갑,479,21,458,8,15,7,0,0,73,0,376,0,0,0,0,0,0,0,3,0,18,0,0,8,15,7,0,0,70,0,358,0,0
제20대,UQ282145,이재정,李在汀,더불어민주당,비례대표,858,81,777,16,40,15,0,1,224,5,557,0,0,1,2,0,0,0,15,1,62,0,0,15,38,15,0,1,209,4,495,0,0
제20대,VHK3402G,정우택,鄭宇澤,새누리당,충북 청주시상당구,299,31,268,7,15,7,0,0,59,2,209,0,0,0,0,0,0,0,7,0,24,0,0,7,15,7,0,0,52,2,185,0,0
제20대,GDN7894V,채이배,蔡利培,국민의당,비례대표,966,128,838,14,32,5,0,5,205,4,701,0,0,3,4,2,0,2,20,0,97,0,0,11,28,3,0,3,185,4,604,0,0
제20대,5DR6334X,윤일규,尹一逵,더불어민주당,충남 천안시병,593,64,529,14,30,10,0,0,137,1,401,0,0,1,6,0,0,0,15,0,42,0,0,13,24,10,0,0,122,1,359,0,0
제20대,9FL71418,이규희,李揆熙,더불어민주당,충남 천안시갑,481,15,466,4,17,5,0,0,88,0,367,0,0,0,1,0,0,0,2,0,12,0,0,4,16,5,0,0,86,0,355,0,0
제20대,8BF5855P,박지원,朴智元,국민의당,전남 해남군완도군진도군,671,16,655,28,19,8,0,2,117,3,494,0,0,0,1,0,0,0,1,0,14,0,0,28,18,8,0,2,116,3,480,0,0
제20대,GX38539O,유동수,柳東秀,더불어민주당,인천 계양구갑,1449,78,1371,20,57,12,1,1,283,5,1070,0,0,2,1,0,0,0,12,0,63,0,0,18,56,12,1,1,271,5,1007,0,0
제20대,N4R2421C,박덕흠,朴德欽,새누리당,충북 보은군옥천군영동군괴산군,1832,63,1769,49,85,16,0,1,466,7,1208,0,0,2,5,0,0,0,16,0,40,0,0,47,80,16,0,1,450,7,1168,0,0
제20대,EUR98126,박맹우,朴孟雨,새누리당,울산 남구을,721,57,664,15,29,8,1,1,195,5,467,0,0,0,2,1,0,0,19,0,35,0,0,15,27,7,1,1,176,5,432,0,0
제20대,QTW6852F,이태규,李泰珪,국민의당,비례대표,345,50,295,5,12,6,0,2,67,1,252,0,0,0,1,1,0,0,8,1,39,0,0,5,11,5,0,2,59,0,213,0,0
제20대,K5F2023J,이학영,李學永,더불어민주당,경기 군포시을,1316,146,1170,34,36,17,0,2,293,6,928,0,0,2,2,3,0,0,7,0,132,0,0,32,34,14,0,2,286,6,796,0,0
제20대,GW55008L,홍의락,洪宜洛,무소속,대구 북구을,617,73,544,20,27,6,0,0,143,4,417,0,0,2,1,1,0,0,18,1,50,0,0,18,26,5,0,0,125,3,367,0,0
제20대,XQ98168F,강길부,姜吉夫,무소속,울산 울주군,313,21,292,7,10,0,0,0,72,1,223,0,0,1,0,0,0,0,5,0,15,0,0,6,10,0,0,0,67,1,208,0,0
제20대,7AN97172,이정현,李貞鉉,새누리당,전남 순천시,188,13,175,9,8,1,0,3,53,2,112,0,0,1,0,0,0,0,4,0,8,0,0,8,8,1,0,3,49,2,104,0,0
제20대,LDY9563L,윤상직,尹相直,새누리당,부산 기장군,425,46,379,8,14,4,0,0,80,3,316,0,0,0,1,0,0,0,13,0,32,0,0,8,13,4,0,0,67,3,284,0,0
제20대,JWW6081H,이상돈,李相敦,국민의당,비례대표,234,20,214,2,11,1,0,1,74,4,141,0,0,0,1,0,0,0,2,0,17,0,0,2,10,1,0,1,72,4,124,0,0
제20대,TZP9391O,이철규,李喆圭,무소속,강원 동해시삼척시,483,44,439,10,20,2,0,0,105,1,345,0,0,1,1,0,0,0,5,0,37,0,0,9,19,2,0,0,100,1,308,0,0
제20대,CJX51868,정종섭,鄭宗燮,새누리당,대구 동구갑,310,29,281,10,8,3,0,0,68,0,221,0,0,1,1,0,0,0,7,0,20,0,0,9,7,3,0,0,61,0,201,0,0
제20대,9WQ7845Z,강효상,姜孝祥,새누리당,비례대표,389,74,315,22,15,6,0,0,79,2,265,0,0,1,0,0,0,0,14,1,58,0,0,21,15,6,0,0,65,1,207,0,0
제20대,B7R2742J,기동민,奇東旻,더불어민주당,서울 성북구을,1604,116,1488,21,59,18,0,0,377,7,1122,0,0,2,3,3,0,0,46,0,62,0,0,19,56,15,0,0,331,7,1060,0,0
제20대,8EL9225R,박준영,朴晙瑩,국민의당,전남 영암군무안군신안군,499,19,480,14,40,5,0,3,144,6,287,0,0,0,0,0,0,0,2,2,15,0,0,14,40,5,0,3,142,4,272,0,0
제20대,8X46899U,윤소하,尹昭夏,정의당,비례대표,1213,130,1083,10,29,13,0,7,297,6,851,0,0,0,0,1,0,0,44,0,85,0,0,10,29,12,0,7,253,6,766,0,0
제20대,1MU99298,김철민,金哲玟,더불어민주당,경기 안산시상록구을,2432,130,2302,47,110,16,1,0,537,14,1707,0,0,0,3,4,0,0,24,0,99,0,0,47,107,12,1,0,513,14,1608,0,0
제20대,QUO78839,박재호,朴在昊,더불어민주당,부산 남구을,1599,64,1535,32,67,25,1,0,348,8,1118,0,0,0,4,0,0,0,17,0,43,0,0,32,63,25,1,0,331,8,1075,0,0
제20대,M6K7940A,오세정,吳世正,국민의당,비례대표,504,30,474,5,24,6,0,4,116,9,340,0,0,0,1,0,0,0,8,0,21,0,0,5,23,6,0,4,108,9,319,0,0
제20대,RQQ3807K,위성곤,魏聖坤,더불어민주당,제주 서귀포시,1556,96,1460,30,83,15,0,3,403,7,1015,0,0,1,8,0,0,0,38,0,49,0,0,29,75,15,0,3,365,7,966,0,0
제20대,IUE5875N,이정미,李貞味,정의당,비례대표,870,81,789,7,17,7,0,7,187,7,638,0,0,0,1,1,0,0,16,0,63,0,0,7,16,6,0,7,171,7,575,0,0
제20대,WNN9272X,장석춘,張錫春,새누리당,경북 구미시을,644,36,608,22,26,6,0,1,166,3,420,0,0,0,4,0,0,0,10,0,22,0,0,22,22,6,0,1,156,3,398,0,0
제20대,JOY4394O,황주홍,黃柱洪,국민의당,전남 고흥군보성군장흥군강진군,3298,696,2602,146,168,43,0,7,792,35,2107,0,0,15,37,6,0,0,162,14,462,0,0,131,131,37,0,7,630,21,1645,0,0
제20대,QB390802,김병관,金炳官,더불어민주당,경기 성남시분당구갑,916,60,856,24,44,15,0,3,189,3,638,0,0,2,0,2,0,0,9,0,47,0,0,22,44,13,0,3,180,3,591,0,0
제20대,6RP89579,김정우,金政祐,더불어민주당,경기 군포시갑,2169,109,2060,55,96,28,0,5,589,9,1387,0,0,0,2,1,0,3,35,0,68,0,0,55,94,27,0,2,554,9,1319,0,0
제20대,G1570880,신동근,申東根,더불어민주당,인천 서구을,675,82,593,19,36,4,0,0,123,0,493,0,0,8,4,0,0,0,19,0,51,0,0,11,32,4,0,0,104,0,442,0,0
제20대,WDS6044S,이채익,李埰益,새누리당,울산 남구갑,810,41,769,23,45,8,0,0,219,8,507,0,0,1,4,0,0,0,9,0,27,0,0,22,41,8,0,0,210,8,480,0,0
제20대,QZF33498,전희경,全希卿,새누리당,비례대표,370,28,342,17,18,4,0,0,99,3,229,0,0,6,1,0,0,0,5,0,16,0,0,11,17,4,0,0,94,3,213,0,0
제20대,Q9H5708M,김진표,金振杓,더불어민주당,경기 수원시무,330,20,310,15,13,4,0,1,76,2,219,0,0,1,0,0,0,0,6,0,13,0,0,14,13,4,0,1,70,2,206,0,0
제20대,MC32279F,박선숙,朴仙淑,국민의당,비례대표,781,69,712,15,36,13,0,1,150,3,563,0,0,0,5,0,0,0,16,0,48,0,0,15,31,13,0,1,134,3,515,0,0
제20대,6AU2417B,박주민,朴柱民,더불어민주당,서울 은평구갑,1258,132,1126,26,50,12,0,5,284,4,877,0,0,0,4,0,0,1,16,0,111,0,0,26,46,12,0,4,268,4,766,0,0
제20대,ZJI5740K,최운열,崔運烈,더불어민주당,비례대표,642,47,595,8,22,9,0,0,97,2,504,0,0,1,2,0,0,0,6,0,38,0,0,7,20,9,0,0,91,2,466,0,0
제20대,BTP28870,이훈,李薰,더불어민주당,서울 금천구,654,38,616,13,29,8,0,3,148,4,449,0,0,3,5,1,0,0,8,1,20,0,0,10,24,7,0,3,140,3,429,0,0
제20대,LJK4960Z,정점식,鄭点植,자유한국당,경남 통영시고성군,77,11,66,2,1,2,0,0,14,1,57,0,0,0,0,0,0,0,0,0,11,0,0,2,1,2,0,0,14,1,46,0,0
제20대,R365233W,홍철호,洪哲鎬,새누리당,경기 김포시을,662,54,608,19,21,13,0,0,143,4,462,0,0,0,0,0,0,0,7,0,47,0,0,19,21,13,0,0,136,4,415,0,0
제20대,PLR62452,김영우,金榮宇,새누리당,경기 포천시가평군,368,21,347,10,8,4,0,0,77,1,268,0,0,0,0,0,0,0,6,0,15,0,0,10,8,4,0,0,71,1,253,0,0
제20대,J2O8643H,도종환,都鍾煥,더불어민주당,충북 청주시흥덕구,416,30,386,18,23,13,0,3,99,2,258,0,0,0,1,5,0,0,8,0,16,0,0,18,22,8,0,3,91,2,242,0,0
제20대,V429892C,정성호,鄭成湖,더불어민주당,경기 양주시,1614,77,1537,26,74,18,0,4,387,10,1095,0,0,1,3,2,0,0,22,0,49,0,0,25,71,16,0,4,365,10,1046,0,0
제20대,NQR1206Q,정진석,鄭鎭碩,새누리당,충남 공주시부여군청양군,364,21,343,8,11,4,0,0,84,1,256,0,0,0,1,1,0,0,3,1,15,0,0,8,10,3,0,0,81,0,241,0,0
제20대,3SP89633,천정배,千正培,국민의당,광주 서구을,762,57,705,9,22,22,0,6,154,1,548,0,0,0,0,2,0,0,7,0,48,0,0,9,22,20,0,6,147,1,500,0,0
제20대,LPB30152,최인호,崔仁昊,더불어민주당,부산 사하구갑,1521,107,1414,26,65,23,0,1,293,8,1105,0,0,2,2,2,0,0,16,0,85,0,0,24,63,21,0,1,277,8,1020,0,0
제20대,3NM5411H,김광수,金光守,국민의당,전북 전주시갑,1322,152,1170,28,55,23,0,3,316,5,892,0,0,5,3,2,0,0,38,0,104,0,0,23,52,21,0,3,278,5,788,0,0
제20대,XEF29171,안호영,安浩永,더불어민주당,전북 완주군진안군무주군장수군,1376,64,1312,23,79,10,1,0,323,4,936,0,0,0,6,0,0,0,28,0,30,0,0,23,73,10,1,0,295,4,906,0,0
제20대,5KV82250,조경태,趙慶泰,새누리당,부산 사하구을,658,79,579,10,24,4,0,1,184,8,427,0,0,1,3,1,0,0,10,0,64,0,0,9,21,3,0,1,174,8,363,0,0
제20대,EX94352K,표창원,表蒼園,더불어민주당,경기 용인시정,839,57,782,10,37,9,0,3,172,0,608,0,0,0,2,2,0,0,7,0,46,0,0,10,35,7,0,3,165,0,562,0,0
제20대,3UZ61136,허윤정,許允貞,더불어민주당,비례대표,25,4,21,0,1,0,0,0,14,0,10,0,0,0,0,0,0,0,1,0,3,0,0,0,1,0,0,0,13,0,7,0,0
제20대,YOG1280B,안철수,安哲秀,국민의당,서울 노원구병,44,9,35,1,4,0,0,1,6,1,31,0,0,0,1,0,0,0,1,1,6,0,0,1,3,0,0,1,5,0,25,0,0
제20대,0582116P,이우현,李愚鉉,새누리당,경기 용인시갑,423,23,400,12,31,10,0,0,126,3,241,0,0,1,3,1,0,0,11,0,7,0,0,11,28,9,0,0,115,3,234,0,0
제20대,I0F2578R,김종대,金鍾大,정의당,비례대표,769,27,742,4,16,9,0,5,159,7,569,0,0,0,0,0,0,0,5,0,22,0,0,4,16,9,0,5,154,7,547,0,0
제20대,YBM9779M,김한표,金漢杓,새누리당,경남 거제시,352,26,326,8,19,2,0,0,74,2,247,0,0,1,3,0,0,0,7,1,14,0,0,7,16,2,0,0,67,1,233,0,0
제20대,S8431719,박영선,朴映宣,더불어민주당,서울 구로구을,356,31,325,6,15,7,0,2,77,7,242,0,0,1,0,2,0,2,7,0,19,0,0,5,15,5,0,0,70,7,223,0,0
제20대,WYC63862,신창현,申昌賢,더불어민주당,경기 의왕시과천시,3529,152,3377,65,137,23,0,3,752,10,2539,0,0,1,4,1,0,0,28,0,118,0,0,64,133,22,0,3,724,10,2421,0,0
제20대,CAL85655,유기준,兪奇濬,새누리당,부산 서구동구,491,19,472,9,18,1,0,0,105,5,353,0,0,0,2,0,0,0,0,0,17,0,0,9,16,1,0,0,105,5,336,0,0
제20대,2SE64657,이장우,李莊雨,새누리당,대전 동구,249,35,214,4,6,4,0,0,47,4,184,0,0,0,1,0,0,0,4,0,30,0,0,4,5,4,0,0,43,4,154,0,0
제20대,23D73143,경대수,慶大秀,새누리당,충북 증평군진천군음성군,930,55,875,74,58,7,1,2,261,4,523,0,0,5,3,0,0,0,11,0,36,0,0,69,55,7,1,2,250,4,487,0,0
제20대,LH97552Q,김도읍,金度邑,새누리당,부산 북구강서구을,986,238,748,38,58,5,0,2,245,6,632,0,0,18,11,0,0,0,51,1,157,0,0,20,47,5,0,2,194,5,475,0,0
제20대,0ID22746,이진복,李珍福,새누리당,부산 동래구,475,19,456,9,14,3,0,0,116,1,332,0,0,0,0,0,0,0,8,0,11,0,0,9,14,3,0,0,108,1,321,0,0
제20대,MBS2896E,이현재,李賢在,새누리당,경기 하남시,533,35,498,11,26,9,0,1,163,6,317,0,0,1,0,0,0,0,15,0,19,0,0,10,26,9,0,1,148,6,298,0,0
제20대,6DG91769,원혜영,元惠榮,더불어민주당,경기 부천시오정구,942,56,886,22,43,7,0,2,192,8,668,0,0,0,4,0,0,0,4,1,47,0,0,22,39,7,0,2,188,7,621,0,0
제20대,X9Y63914,이용주,李勇周,국민의당,전남 여수시갑,942,26,916,49,35,19,0,5,225,9,600,0,0,0,2,2,0,0,9,0,13,0,0,49,33,17,0,5,216,9,587,0,0
제20대,BLC8630L,박병석,朴炳錫,더불어민주당,대전 서구갑,109,28,81,4,8,3,0,0,23,0,71,0,0,0,2,0,0,0,7,0,19,0,0,4,6,3,0,0,16,0,52,0,0
제20대,O0G3169T,백승주,白承周,새누리당,경북 구미시갑,356,56,300,8,10,3,0,0,68,2,265,0,0,5,1,0,0,0,9,0,41,0,0,3,9,3,0,0,59,2,224,0,0
제20대,BN49469V,신경민,辛京珉,더불어민주당,서울 영등포구을,1318,86,1232,50,52,20,0,4,314,3,875,0,0,0,4,0,0,0,12,0,70,0,0,50,48,20,0,4,302,3,805,0,0
제20대,R7N74579,이수혁,李秀赫,더불어민주당,비례대표,603,31,572,13,18,13,0,1,106,1,451,0,0,0,1,0,0,0,5,0,25,0,0,13,17,13,0,1,101,1,426,0,0
제20대,ZGA4092Y,정용기,鄭容起,새누리당,대전 대덕구,259,21,238,4,13,2,0,0,75,0,165,0,0,1,1,0,0,0,10,0,9,0,0,3,12,2,0,0,65,0,156,0,0
제20대,T2K9554I,홍문종,洪文鐘,새누리당,경기 의정부시을,362,6,356,13,22,8,0,1,96,1,221,0,0,0,0,1,0,0,0,0,5,0,0,13,22,7,0,1,96,1,216,0,0
제20대,O149331C,권석창,權錫昌,새누리당,충북 제천시단양군,461,20,441,22,36,5,0,1,149,5,243,0,0,0,1,0,0,0,7,0,12,0,0,22,35,5,0,1,142,5,231,0,0
제20대,6QU2958D,김해영,金海永,더불어민주당,부산 연제구,2392,112,2280,87,71,25,0,6,574,19,1610,0,0,6,1,1,0,1,15,1,87,0,0,81,70,24,0,5,559,18,1523,0,0
제20대,V0O5343U,우상호,禹相虎,더불어민주당,서울 서대문구갑,148,37,111,4,6,5,0,0,28,0,105,0,0,2,2,0,0,0,8,0,25,0,0,2,4,5,0,0,20,0,80,0,0
제20대,0AI7568W,장정숙,張貞淑,국민의당,비례대표,1985,65,1920,20,62,33,0,6,423,11,1430,0,0,2,0,2,0,0,18,0,43,0,0,18,62,31,0,6,405,11,1387,0,0
제20대,A3H7195R,박완주,朴完柱,더불어민주당,충남 천안시을,416,95,321,38,26,8,0,0,110,2,232,0,0,9,13,1,0,0,34,0,38,0,0,29,13,7,0,0,76,2,194,0,0
제20대,MTK2954E,신용현,申容賢,국민의당,비례대표,1164,89,1075,25,52,23,0,5,276,4,779,0,0,0,7,2,0,0,16,0,64,0,0,25,45,21,0,5,260,4,715,0,0
제20대,PAB29217,김성찬,金盛贊,새누리당,경남 창원시진해구,1249,91,1158,62,53,6,0,1,347,7,773,0,0,3,6,1,0,0,39,1,41,0,0,59,47,5,0,1,308,6,732,0,0
제20대,ABT2266H,이용득,李龍得,더불어민주당,비례대표,1212,76,1136,31,52,13,0,3,290,5,818,0,0,1,4,0,0,0,14,0,57,0,0,30,48,13,0,3,276,5,761,0,0
제20대,S824682L,박홍근,朴洪根,더불어민주당,서울 중랑구을,1607,158,1449,32,63,14,0,2,333,10,1153,0,0,9,14,0,0,0,34,2,99,0,0,23,49,14,0,2,299,8,1054,0,0
제20대,ZDR63255,소병훈,蘇秉勳,더불어민주당,경기 광주시갑,1835,100,1735,25,92,16,0,3,403,6,1290,0,0,1,8,1,0,0,23,0,67,0,0,24,84,15,0,3,380,6,1223,0,0
제20대,ZBX31520,손혜원,孫惠園,더불어민주당,서울 마포구을,767,38,729,63,36,7,0,1,190,1,469,0,0,7,3,0,0,0,13,0,15,0,0,56,33,7,0,1,177,1,454,0,0
제20대,HE838063,신보라,申普羅,새누리당,비례대표,664,84,580,25,27,4,0,0,177,2,429,0,0,4,5,0,0,0,24,0,51,0,0,21,22,4,0,0,153,2,378,0,0
제20대,DKB8522X,정인화,鄭仁和,국민의당,전남 광양시곡성군구례군,1681,111,1570,43,82,19,0,4,382,17,1134,0,0,7,4,1,0,0,33,0,66,0,0,36,78,18,0,4,349,17,1068,0,0
제20대,1KD95875,함진규,咸珍圭,새누리당,경기 시흥시갑,1032,156,876,40,55,12,0,0,272,7,646,0,0,4,5,1,0,0,24,1,121,0,0,36,50,11,0,0,248,6,525,0,0
제20대,YKW37422,권은희,權垠希,국민의당,광주 광산구을,551,64,487,6,18,10,0,3,98,1,415,0,0,0,1,0,0,0,9,0,54,0,0,6,17,10,0,3,89,1,361,0,0
제20대,A935446Z,김종훈,金鍾勳,무소속,울산 동구,490,20,470,6,17,8,0,5,86,1,367,0,0,0,0,0,0,0,1,0,19,0,0,6,17,8,0,5,85,1,348,0,0
제20대,IYD4143Y,문희상,文喜相,더불어민주당,경기 의정부시갑,472,24,448,20,15,4,0,2,106,2,323,0,0,1,0,0,0,0,4,0,19,0,0,19,15,4,0,2,102,2,304,0,0
제20대,3TP65086,윤종오,尹鍾五,무소속,울산 북구,336,11,325,11,13,7,0,6,61,4,234,0,0,0,0,0,0,0,1,0,10,0,0,11,13,7,0,6,60,4,224,0,0
제20대,IDV9108J,진영,陳永,더불어민주당,서울 용산구,67,2,65,3,3,2,0,0,7,1,51,0,0,0,0,0,0,0,0,1,1,0,0,3,3,2,0,0,7,0,50,0,0
제20대,ZKU88693,김경협,金炅俠,더불어민주당,경기 부천시원미구갑,1290,67,1223,23,33,11,0,3,281,8,931,0,0,1,0,1,0,0,11,0,54,0,0,22,33,10,0,3,270,8,877,0,0
제20대,RCF90176,김성식,金成植,국민의당,서울 관악구갑,191,21,170,5,11,0,0,3,63,0,109,0,0,0,2,0,0,0,13,0,6,0,0,5,9,0,0,3,50,0,103,0,0
제20대,XBT9550Q,우원식,禹元植,더불어민주당,서울 노원구을,977,67,910,11,32,10,0,2,173,5,744,0,0,3,2,1,0,0,11,0,50,0,0,8,30,9,0,2,162,5,694,0,0
제20대,WVU2479T,이상헌,李相憲,더불어민주당,울산 북구,595,38,557,14,23,5,0,0,84,0,469,0,0,1,1,0,0,0,5,0,31,0,0,13,22,5,0,0,79,0,438,0,0
제20대,NS06841K,이철우,李喆雨,새누리당,경북 김천시,188,14,174,6,14,3,0,0,54,4,107,0,0,1,1,0,0,0,0,0,12,0,0,5,13,3,0,0,54,4,95,0,0
제20대,D397960C,조훈현,曺薰鉉,새누리당,비례대표,641,46,595,16,25,9,0,2,153,6,430,0,0,4,1,5,0,0,11,0,25,0,0,12,24,4,0,2,142,6,405,0,0
제20대,ZX71333R,한선교,韓善敎,새누리당,경기 용인시병,234,31,203,19,16,5,0,1,49,1,143,0,0,0,4,5,0,0,1,0,21,0,0,19,12,0,0,1,48,1,122,0,0
제20대,ZL32287Z,김삼화,金三和,국민의당,비례대표,1740,160,1580,34,84,23,0,6,383,9,1201,0,0,6,8,3,0,0,49,1,93,0,0,28,76,20,0,6,334,8,1108,0,0
제20대,HSS7466Y,백혜련,白惠蓮,더불어민주당,경기 수원시을,1614,160,1454,35,63,17,0,2,383,5,1109,0,0,3,10,0,0,0,36,2,109,0,0,32,53,17,0,2,347,3,1000,0,0
제20대,8T51904N,박찬우,朴贊佑,새누리당,충남 천안시갑,319,31,288,23,28,3,0,0,96,5,164,0,0,1,5,1,0,0,14,0,10,0,0,22,23,2,0,0,82,5,154,0,0
제20대,9CR4440H,배덕광,裵德光,새누리당,부산 해운대구을,219,20,199,8,9,2,0,0,68,1,131,0,0,0,0,0,0,0,6,0,14,0,0,8,9,2,0,0,62,1,117,0,0
제20대,O7R5461J,윤후덕,尹厚德,더불어민주당,경기 파주시갑,2097,133,1964,39,81,8,0,2,511,13,1443,0,0,2,3,1,0,0,33,0,94,0,0,37,78,7,0,2,478,13,1349,0,0
제20대,UM51067K,인재근,印在謹,더불어민주당,서울 도봉구갑,1492,117,1375,26,59,16,0,3,369,8,1011,0,0,0,1,0,0,0,33,0,83,0,0,26,58,16,0,3,336,8,928,0,0
제20대,BIR8594P,임재훈,林哉勳,바른미래당,비례대표,278,27,251,7,14,0,0,0,41,0,216,0,0,2,4,0,0,0,2,0,19,0,0,5,10,0,0,0,39,0,197,0,0
제20대,FJ03481D,최경환,崔炅煥,자유한국당,경북 경산시,29,2,27,0,2,0,0,0,12,1,14,0,0,0,0,0,0,0,0,0,2,0,0,0,2,0,0,0,12,1,12,0,0
제20대,SNJ6318D,김무성,金武星,새누리당,부산 중구영도구,303,2,301,3,12,0,0,0,62,0,226,0,0,0,0,0,0,0,0,0,2,0,0,3,12,0,0,0,62,0,224,0,0
제20대,7R156073,박범계,朴範界,더불어민주당,대전 서구을,284,44,240,5,17,7,0,3,51,2,199,0,0,0,2,0,0,0,8,1,33,0,0,5,15,7,0,3,43,1,166,0,0
제20대,TGL10010,문미옥,文美玉,더불어민주당,비례대표,602,33,569,14,27,10,0,8,136,4,403,0,0,8,5,0,0,0,4,0,16,0,0,6,22,10,0,8,132,4,387,0,0
제20대,PEP6922S,박용진,朴用鎭,더불어민주당,서울 강북구을,699,94,605,14,27,4,0,1,148,4,501,0,0,2,0,1,0,0,11,1,79,0,0,12,27,3,0,1,137,3,422,0,0
제20대,PAO22428,송영길,宋永吉,더불어민주당,인천 계양구을,504,35,469,6,20,5,0,2,96,2,373,0,0,0,2,0,0,0,2,0,31,0,0,6,18,5,0,2,94,2,342,0,0
제20대,B751170H,여영국,余永國,정의당,경남 창원시성산구,84,11,73,0,3,1,0,0,8,0,72,0,0,0,0,0,0,0,0,0,11,0,0,0,3,1,0,0,8,0,61,0,0
제20대,TO79481Z,최교일,崔敎一,새누리당,경북 영주시문경시예천군,517,51,466,9,12,7,0,1,115,0,373,0,0,0,1,0,0,0,14,0,36,0,0,9,11,7,0,1,101,0,337,0,0
제20대,TRE2429O,강훈식,姜勳植,더불어민주당,충남 아산시을,1478,75,1403,38,70,11,0,1,373,7,978,0,0,0,8,0,0,0,17,0,50,0,0,38,62,11,0,1,356,7,928,0,0
제20대,HTK5293K,김종회,金鍾懷,국민의당,전북 김제시부안군,2004,180,1824,100,104,28,0,3,507,21,1241,0,0,43,5,2,0,0,33,0,97,0,0,57,99,26,0,3,474,21,1144,0,0
제20대,1PZ8289D,송희경,宋喜卿,새누리당,비례대표,981,74,907,17,55,17,0,0,228,7,657,0,0,0,3,0,0,0,24,0,47,0,0,17,52,17,0,0,204,7,610,0,0
제20대,16D7652C,이원욱,李元旭,더불어민주당,경기 화성시을,1559,106,1453,32,75,12,0,3,380,12,1045,0,0,1,5,1,0,0,28,1,70,0,0,31,70,11,0,3,352,11,975,0,0
제20대,HSW1214Q,이종배,李鍾培,새누리당,충북 충주시,861,95,766,21,38,6,0,1,229,3,563,0,0,6,3,0,0,0,20,0,66,0,0,15,35,6,0,1,209,3,497,0,0
제20대,BWD92364,이찬열,李燦烈,더불어민주당,경기 수원시갑,4201,324,3877,119,159,44,0,9,952,39,2879,0,0,21,9,1,0,0,97,4,192,0,0,98,150,43,0,9,855,35,2687,0,0
제20대,LCJ77278,이혜훈,李惠薰,새누리당,서울 서초구갑,203,26,177,3,6,1,0,0,40,1,152,0,0,1,2,0,0,0,8,0,15,0,0,2,4,1,0,0,32,1,137,0,0
제20대,DCN7433W,정세균,丁世均,더불어민주당,서울 종로구,638,21,617,11,27,8,0,0,106,1,485,0,0,0,1,0,0,0,7,0,13,0,0,11,26,8,0,0,99,1,472,0,0
제20대,IWK63872,조배숙,趙培淑,국민의당,전북 익산시을,1291,54,1237,33,63,20,0,4,279,4,888,0,0,0,4,0,0,0,10,1,39,0,0,33,59,20,0,4,269,3,849,0,0
제20대,8WC7967F,김승희,金承禧,새누리당,비례대표,1113,167,946,20,40,15,0,1,308,7,722,0,0,1,4,3,0,0,52,2,105,0,0,19,36,12,0,1,256,5,617,0,0
제20대,0W194007,김영주,金榮珠,더불어민주당,서울 영등포구갑,741,49,692,21,15,5,0,2,152,4,542,0,0,0,1,1,0,1,9,0,37,0,0,21,14,4,0,1,143,4,505,0,0
제20대,7W35098M,윤준호,尹俊晧,더불어민주당,부산 해운대구을,1002,64,938,70,35,12,0,0,208,2,675,0,0,3,3,3,0,0,25,0,30,0,0,67,32,9,0,0,183,2,645,0,0
제20대,OQO34632,이동섭,李銅燮,국민의당,비례대표,2322,101,2221,55,107,28,0,8,547,16,1561,0,0,2,4,2,0,0,26,0,67,0,0,53,103,26,0,8,521,16,1494,0,0
제20대,OSV9142K,이만희,李晩熙,새누리당,경북 영천시청도군,512,69,443,25,16,12,0,0,122,3,334,0,0,6,3,1,0,0,23,0,36,0,0,19,13,11,0,0,99,3,298,0,0
제20대,7BM2933Y,김영호,金映豪,더불어민주당,서울 서대문구을,1157,87,1070,27,43,19,0,1,247,5,815,0,0,0,1,0,0,0,20,0,66,0,0,27,42,19,0,1,227,5,749,0,0
제20대,E5N8503B,김종인,金鍾仁,더불어민주당,비례대표,19,1,18,1,1,0,0,0,2,1,14,0,0,0,0,0,0,0,0,0,1,0,0,1,1,0,0,0,2,1,13,0,0
제20대,XSP20229,김성환,金星煥,더불어민주당,서울 노원구병,101,12,89,1,3,3,0,0,19,1,74,0,0,0,0,0,0,0,3,1,8,0,0,1,3,3,0,0,16,0,66,0,0
제20대,V2R7430Z,이춘석,李春錫,더불어민주당,전북 익산시갑,1313,87,1226,69,51,14,0,6,298,8,867,0,0,0,0,0,0,0,13,1,73,0,0,69,51,14,0,6,285,7,794,0,0
제20대,SEK1881Q,유재중,柳在仲,새누리당,부산 수영구,374,25,349,9,15,2,0,0,84,1,263,0,0,0,2,0,0,0,3,0,20,0,0,9,13,2,0,0,81,1,243,0,0
제20대,QXD2505Y,이후삼,李厚三,더불어민주당,충북 제천시단양군,388,15,373,5,24,3,0,0,80,1,275,0,0,0,2,0,0,0,3,0,10,0,0,5,22,3,0,0,77,1,265,0,0
제20대,MHK9919B,곽상도,郭尙道,새누리당,대구 중구남구,443,69,374,11,13,2,0,1,96,0,320,0,0,0,1,0,0,0,10,0,58,0,0,11,12,2,0,1,86,0,262,0,0
제20대,SQ36001H,송기헌,宋基憲,더불어민주당,강원 원주시을,818,67,751,13,35,11,1,0,164,4,590,0,0,2,2,3,1,0,14,0,45,0,0,11,33,8,0,0,150,4,545,0,0
제20대,QZR19240,금태섭,琴泰燮,더불어민주당,서울 강서구갑,817,76,741,14,31,9,0,1,169,1,592,0,0,0,1,0,0,0,6,0,69,0,0,14,30,9,0,1,163,1,523,0,0
제20대,W4X85128,박대출,朴大出,새누리당,경남 진주시갑,395,56,339,7,19,3,0,0,86,3,277,0,0,0,2,0,0,0,8,0,46,0,0,7,17,3,0,0,78,3,231,0,0
제20대,9S468336,정재호,鄭在浩,더불어민주당,경기 고양시을,1088,47,1041,20,44,5,0,0,217,3,799,0,0,0,0,0,0,0,8,0,39,0,0,20,44,5,0,0,209,3,760,0,0
제20대,SY09851R,김중로,金中魯,국민의당,비례대표,1067,89,978,25,50,17,0,5,293,6,671,0,0,2,10,3,0,0,22,0,52,0,0,23,40,14,0,5,271,6,619,0,0
제20대,24E9427D,박남춘,朴南春,더불어민주당,인천 남동구갑,1272,70,1202,21,44,12,0,4,317,3,871,0,0,3,7,0,0,0,24,0,36,0,0,18,37,12,0,4,293,3,835,0,0
제20대,M2Q9024I,김종민,金鍾民,더불어민주당,충남 논산시계룡시금산군,1074,60,1014,27,32,12,0,4,214,4,781,0,0,0,0,0,0,2,9,2,47,0,0,27,32,12,0,2,205,2,734,0,0
제20대,OTE19384,박명재,朴明在,새누리당,경북 포항시남구울릉군,1423,114,1309,47,66,16,0,1,382,12,899,0,0,3,2,0,0,0,24,0,85,0,0,44,64,16,0,1,358,12,814,0,0
제20대,CZB4125D,장제원,張濟元,무소속,부산 사상구,262,52,210,8,8,2,0,1,40,1,202,0,0,5,3,0,0,0,13,0,31,0,0,3,5,2,0,1,27,1,171,0,0
제20대,NZF1659U,정운천,鄭雲天,새누리당,전북 전주시을,650,34,616,38,30,6,0,0,137,5,434,0,0,4,1,0,0,0,9,0,20,0,0,34,29,6,0,0,128,5,414,0,0
제20대,DTG4846A,김선동,金善東,새누리당,서울 도봉구을,705,36,669,18,33,7,1,0,182,1,463,0,0,2,2,0,0,0,4,0,28,0,0,16,31,7,1,0,178,1,435,0,0
제20대,5K343700,김수민,金秀玟,국민의당,비례대표,1239,79,1160,37,54,17,0,3,283,10,835,0,0,0,4,0,0,0,19,1,55,0,0,37,50,17,0,3,264,9,780,0,0
제20대,E6U4345C,임종성,林鍾聲,더불어민주당,경기 광주시을,1522,72,1450,48,80,18,0,0,372,8,996,0,0,2,8,0,0,0,22,0,40,0,0,46,72,18,0,0,350,8,956,0,0
제20대,GFF1986K,김병욱,金炳旭,더불어민주당,경기 성남시분당구을,1521,119,1402,29,52,17,0,2,351,7,1063,0,0,3,4,1,0,0,26,3,82,0,0,26,48,16,0,2,325,4,981,0,0
제20대,E1J8836Y,김정재,金汀才,새누리당,경북 포항시북구,1236,89,1147,39,46,13,0,2,275,11,850,0,0,2,3,1,0,0,16,1,66,0,0,37,43,12,0,2,259,10,784,0,0
제20대,7KD2317D,김순례,金順禮,새누리당,비례대표,509,48,461,8,14,8,0,0,137,3,339,0,0,1,1,0,0,0,21,0,25,0,0,7,13,8,0,0,116,3,314,0,0
제20대,AMF4093D,김용태,金容兌,새누리당,서울 양천구을,462,22,440,8,16,0,1,1,111,1,324,0,0,0,2,0,0,0,6,0,14,0,0,8,14,0,1,1,105,1,310,0,0
제20대,YLM92014,박순자,朴順子,새누리당,경기 안산시단원구을,400,29,371,3,12,5,0,1,103,2,274,0,0,0,1,1,0,0,9,1,17,0,0,3,11,4,0,1,94,1,257,0,0
제20대,IQ54138I,박인숙,朴仁淑,새누리당,서울 송파구갑,900,147,753,11,25,10,0,1,197,2,654,0,0,1,3,6,0,1,33,1,102,0,0,10,22,4,0,0,164,1,552,0,0
제20대,FOK3459D,서삼석,徐參錫,더불어민주당,전남 영암군무안군신안군,516,49,467,2,26,5,0,0,102,2,379,0,0,0,3,0,0,0,13,0,33,0,0,2,23,5,0,0,89,2,346,0,0
제20대,H337332S,오신환,吳晨煥,새누리당,서울 관악구을,364,39,325,11,17,2,0,0,66,1,267,0,0,0,2,0,0,0,8,0,29,0,0,11,15,2,0,0,58,1,238,0,0
제20대,RH454994,권미혁,權美赫,더불어민주당,비례대표,1155,129,1026,20,52,18,0,1,301,5,758,0,0,0,4,0,0,0,40,2,83,0,0,20,48,18,0,1,261,3,675,0,0
제20대,GXT11570,김성수,金聖洙,더불어민주당,비례대표,948,38,910,27,41,7,0,1,209,5,658,0,0,2,0,0,0,0,5,0,31,0,0,25,41,7,0,1,204,5,627,0,0
제20대,FRN1867O,홍익표,洪翼杓,더불어민주당,서울 중구성동구갑,617,112,505,15,36,11,0,1,128,7,419,0,0,2,5,5,0,0,23,1,76,0,0,13,31,6,0,1,105,6,343,0,0
제20대,I7Z3068X,유성엽,柳成葉,국민의당,전북 정읍시고창군,1137,45,1092,53,50,16,0,3,224,14,777,0,0,1,5,0,0,0,4,0,35,0,0,52,45,16,0,3,220,14,742,0,0
제20대,04T3751T,남인순,南仁順,더불어민주당,서울 송파구병,1189,141,1048,23,49,7,0,1,298,6,805,0,0,1,6,1,0,0,62,2,69,0,0,22,43,6,0,1,236,4,736,0,0
제20대,SVH30067,오제세,吳濟世,더불어민주당,충북 청주시서원구,767,126,641,11,28,9,0,4,248,3,464,0,0,0,2,1,0,0,68,0,55,0,0,11,26,8,0,4,180,3,409,0,0
제20대,8KB8281W,제윤경,諸閏景,더불어민주당,비례대표,923,93,830,9,26,8,0,2,183,2,693,0,0,0,0,0,0,1,8,0,84,0,0,9,26,8,0,1,175,2,609,0,0
제20대,09I2323E,김한정,金漢正,더불어민주당,경기 남양주시을,452,37,415,15,24,14,0,0,104,2,293,0,0,9,1,1,0,0,7,0,19,0,0,6,23,13,0,0,97,2,274,0,0
제20대,8WV8289I,이완영,李完永,새누리당,경북 고령군성주군칠곡군,547,38,509,6,30,3,0,2,151,4,351,0,0,0,3,0,0,0,7,1,27,0,0,6,27,3,0,2,144,3,324,0,0
제20대,21N57758,오영훈,吳怜勳,더불어민주당,제주 제주시을,858,81,777,59,40,13,0,2,212,3,529,0,0,2,4,1,0,0,18,1,55,0,0,57,36,12,0,2,194,2,474,0,0
제20대,PWU27609,유승민,劉承旼,무소속,대구 동구을,369,16,353,14,14,3,0,2,90,2,244,0,0,0,0,1,0,0,4,0,11,0,0,14,14,2,0,2,86,2,233,0,0
제20대,JG77046J,이언주,李彦周,더불어민주당,경기 광명시을,870,104,766,7,11,7,0,1,176,11,657,0,0,0,0,1,0,1,29,1,72,0,0,7,11,6,0,0,147,10,585,0,0
제20대,3ZR4438W,이인영,李仁榮,더불어민주당,서울 구로구갑,333,46,287,6,12,5,0,0,74,0,236,0,0,1,3,2,0,0,6,0,34,0,0,5,9,3,0,0,68,0,202,0,0
제20대,11N7618M,이종명,李鍾明,새누리당,비례대표,1011,62,949,25,47,12,0,1,261,4,661,0,0,0,6,0,0,0,15,0,41,0,0,25,41,12,0,1,246,4,620,0,0
제20대,MGE7194M,김광림,金光琳,새누리당,경북 안동시,558,30,528,9,18,5,0,4,160,0,362,0,0,0,0,0,0,1,19,0,10,0,0,9,18,5,0,3,141,0,352,0,0
제20대,UGH6481E,김상희,金相姬,더불어민주당,경기 부천시소사구,1843,146,1697,34,72,18,0,3,487,14,1215,0,0,1,5,2,0,0,48,1,89,0,0,33,67,16,0,3,439,13,1126,0,0
제20대,SU53086M,심상정,沈相정,정의당,경기 고양시갑,649,45,604,2,11,7,0,5,133,2,489,0,0,0,1,1,0,0,5,0,38,0,0,2,10,6,0,5,128,2,451,0,0
제20대,YVN3115U,김경진,金京鎭,국민의당,광주 북구갑,1427,78,1349,26,59,27,0,2,343,11,959,0,0,0,2,4,0,0,15,0,57,0,0,26,57,23,0,2,328,11,902,0,0
제20대,6EN68926,송언석,宋彦錫,자유한국당,경북 김천시,347,29,318,6,7,2,0,0,74,0,258,0,0,1,0,0,0,0,5,0,23,0,0,5,7,2,0,0,69,0,235,0,0
제20대,K3W33496,박광온,朴洸瑥,더불어민주당,경기 수원시정,1701,389,1312,72,50,21,0,9,365,10,1174,0,0,23,5,7,0,1,108,2,243,0,0,49,45,14,0,8,257,8,931,0,0
제20대,71M8132V,신상진,申相珍,새누리당,경기 성남시중원구,504,81,423,8,17,2,0,1,121,3,352,0,0,0,0,0,0,0,22,2,57,0,0,8,17,2,0,1,99,1,295,0,0
제20대,9414335X,심기준,沈基俊,더불어민주당,비례대표,685,35,650,8,26,7,1,0,144,4,495,0,0,0,1,0,0,0,5,0,29,0,0,8,25,7,1,0,139,4,466,0,0
제20대,I7R13867,이개호,李介昊,더불어민주당,전남 담양군함평군영광군장성군,840,71,769,21,52,16,0,2,230,6,513,0,0,1,3,3,0,0,29,1,34,0,0,20,49,13,0,2,201,5,479,0,0
제20대,DVD2735W,이은권,李殷權,새누리당,대전 중구,716,42,674,13,27,2,0,1,189,1,483,0,0,0,3,0,0,0,14,0,25,0,0,13,24,2,0,1,175,1,458,0,0
제20대,N9X9673B,전혜숙,全惠淑,더불어민주당,서울 광진구갑,1846,115,1731,69,74,8,0,4,496,10,1185,0,0,0,5,0,0,0,23,1,86,0,0,69,69,8,0,4,473,9,1099,0,0
제20대,UIZ3103R,김부겸,金富謙,더불어민주당,대구 수성구갑,286,27,259,2,9,9,0,0,69,0,197,0,0,0,2,2,0,0,2,0,21,0,0,2,7,7,0,0,67,0,176,0,0
제20대,M3Z17237,김재경,金在庚,새누리당,경남 진주시을,413,27,386,6,14,6,0,1,95,3,288,0,0,0,0,0,0,0,1,0,26,0,0,6,14,6,0,1,94,3,262,0,0
제20대,GD131760,홍문표,洪文杓,새누리당,충남 홍성군예산군,965,38,927,29,62,17,0,2,285,8,562,0,0,0,2,1,0,0,10,0,25,0,0,29,60,16,0,2,275,8,537,0,0
제20대,64G6894C,김정훈,金正薰,새누리당,부산 남구갑,185,17,168,5,5,5,0,0,35,2,133,0,0,2,0,0,0,0,4,1,10,0,0,3,5,5,0,0,31,1,123,0,0
제20대,ZYH1940A,이상민,李相珉,더불어민주당,대전 유성구을,192,47,145,6,8,4,0,0,30,0,144,0,0,2,1,1,0,0,9,0,34,0,0,4,7,3,0,0,21,0,110,0,0
제20대,9BE5694R,유승희,兪承希,더불어민주당,서울 성북구갑,1159,131,1028,21,29,11,0,1,239,5,853,0,0,0,0,3,0,0,23,0,105,0,0,21,29,8,0,1,216,5,748,0,0
제20대,0135473I,이군현,李君賢,새누리당,경남 통영시고성군,163,4,159,3,11,5,0,0,40,3,101,0,0,0,1,0,0,0,0,0,3,0,0,3,10,5,0,0,40,3,98,0,0
제20대,OW53107J,설훈,薛勳,더불어민주당,경기 부천시원미구을,1099,154,945,33,58,8,0,2,244,4,750,0,0,4,20,0,0,0,55,0,75,0,0,29,38,8,0,2,189,4,675,0,0
제20대,IQN7588X,이은재,李恩宰,새누리당,서울 강남구병,387,23,364,14,15,1,0,0,46,1,310,0,0,0,1,0,0,0,2,1,19,0,0,14,14,1,0,0,44,0,291,0,0
제20대,LSK9789D,이철희,李哲熙,더불어민주당,비례대표,980,53,927,21,29,7,0,0,206,5,712,0,0,0,3,0,0,0,11,1,38,0,0,21,26,7,0,0,195,4,674,0,0
제20대,68P7228G,진선미,陳善美,더불어민주당,서울 강동구갑,745,105,640,24,26,7,0,2,184,2,500,0,0,2,4,0,0,0,19,0,80,0,0,22,22,7,0,2,165,2,420,0,0
제20대,TOU1222X,강창일,姜昌一,더불어민주당,제주 제주시갑,1131,89,1042,47,51,21,0,0,273,11,728,0,0,1,2,0,0,0,11,1,74,0,0,46,49,21,0,0,262,10,654,0,0
제20대,8DK7238W,백재현,白在鉉,더불어민주당,경기 광명시갑,770,80,690,12,35,2,0,3,179,4,535,0,0,0,2,0,0,0,12,0,66,0,0,12,33,2,0,3,167,4,469,0,0
제20대,5765663F,김영진,金榮鎭,더불어민주당,경기 수원시병,1092,95,997,9,46,7,1,2,267,4,756,0,0,0,1,0,0,2,18,1,73,0,0,9,45,7,1,0,249,3,683,0,0
제20대,JMD3241I,박경미,朴炅美,더불어민주당,비례대표,775,101,674,15,34,9,0,0,180,4,533,0,0,2,5,2,0,0,21,0,71,0,0,13,29,7,0,0,159,4,462,0,0
제20대,7BV5480O,송기석,宋基錫,국민의당,광주 서구갑,444,34,410,11,34,4,0,5,121,8,261,0,0,0,1,0,0,0,8,0,25,0,0,11,33,4,0,5,113,8,236,0,0
제20대,GMK1374L,이석현,李錫玄,더불어민주당,경기 안양시동안구갑,637,63,574,11,32,13,0,0,150,0,431,0,0,0,3,1,0,0,10,0,49,0,0,11,29,12,0,0,140,0,382,0,0
제20대,S9U45255,이양수,李亮壽,새누리당,강원 속초시고성군양양군,811,60,751,60,40,13,0,1,234,9,454,0,0,1,4,0,0,0,22,0,33,0,0,59,36,13,0,1,212,9,421,0,0
제20대,5HG31863,지상욱,池尙昱,새누리당,서울 중구성동구을,291,22,269,19,10,2,0,0,68,1,191,0,0,7,3,0,0,0,0,0,12,0,0,12,7,2,0,0,68,1,179,0,0
제20대,Q6A9034Q,곽대훈,郭大勳,새누리당,대구 달서구갑,1052,64,988,30,42,6,0,1,285,3,685,0,0,3,0,0,0,0,12,0,49,0,0,27,42,6,0,1,273,3,636,0,0
제20대,9D939735,김성원,金成願,새누리당,경기 동두천시연천군,1371,112,1259,44,46,11,0,1,316,6,947,0,0,2,1,0,0,0,17,0,92,0,0,42,45,11,0,1,299,6,855,0,0
제20대,XTB3104O,추혜선,秋惠仙,정의당,비례대표,795,54,741,5,18,9,0,5,167,4,587,0,0,0,0,0,0,0,9,1,44,0,0,5,18,9,0,5,158,3,543,0,0
제20대,KA04352K,최경환,崔敬煥,국민의당,광주 북구을,909,48,861,29,37,17,0,4,192,3,627,0,0,0,2,0,0,0,8,0,38,0,0,29,35,17,0,4,184,3,589,0,0
제20대,URV1689Q,추미애,秋美愛,더불어민주당,서울 광진구을,411,24,387,11,19,6,0,0,89,0,286,0,0,0,0,0,0,0,0,0,24,0,0,11,19,6,0,0,89,0,262,0,0
제20대,TZD17894,원유철,元裕哲,새누리당,경기 평택시갑,840,49,791,25,26,2,0,0,222,4,561,0,0,1,0,0,0,0,4,1,43,0,0,24,26,2,0,0,218,3,518,0,0
제20대,IN328264,조정식,趙正湜,더불어민주당,경기 시흥시을,834,72,762,15,41,7,0,3,266,8,494,0,0,3,6,0,0,0,39,0,24,0,0,12,35,7,0,3,227,8,470,0,0
제20대,W168182V,김관영,金寬永,국민의당,전북 군산시,1594,153,1441,32,85,22,0,6,407,19,1023,0,0,2,5,0,0,0,22,0,124,0,0,30,80,22,0,6,385,19,899,0,0
제20대,NTT8182Q,김민기,金敏基,더불어민주당,경기 용인시을,1195,95,1100,23,59,18,0,1,254,4,836,0,0,3,5,1,0,0,23,0,63,0,0,20,54,17,0,1,231,4,773,0,0
제20대,B6F5266B,엄용수,嚴龍洙,새누리당,경남 밀양시의령군함안군창녕군,639,52,587,14,22,7,0,2,170,2,422,0,0,1,1,0,0,0,21,0,29,0,0,13,21,7,0,2,149,2,393,0,0
제20대,IH436704,강석진,姜錫振,새누리당,경남 산청군함양군거창군합천군,690,53,637,33,29,13,0,0,171,2,442,0,0,3,5,0,0,0,18,0,27,0,0,30,24,13,0,0,153,2,415,0,0
제20대,2WQ6656P,김세연,金世淵,새누리당,부산 금정구,479,35,444,6,19,5,0,1,106,0,342,0,0,0,1,0,0,0,5,0,29,0,0,6,18,5,0,1,101,0,313,0,0
제20대,I0S53762,하태경,河泰慶,새누리당,부산 해운대구갑,617,55,562,21,20,2,0,0,114,4,456,0,0,0,2,0,0,0,11,1,41,0,0,21,18,2,0,0,103,3,415,0,0
제20대,39P2522W,민병두,閔丙두,더불어민주당,서울 동대문구을,961,81,880,11,27,11,0,5,196,3,708,0,0,1,3,0,0,0,15,0,62,0,0,10,24,11,0,5,181,3,646,0,0
제20대,VXQ28579,심재권,沈載權,더불어민주당,서울 강동구을,729,65,664,11,25,8,0,1,139,4,541,0,0,0,1,0,0,0,11,1,52,0,0,11,24,8,0,1,128,3,489,0,0
제20대,XPP2564T,한정애,韓貞愛,더불어민주당,서울 강서구병,1129,140,989,11,46,9,0,0,281,5,777,0,0,1,7,1,0,0,55,3,73,0,0,10,39,8,0,0,226,2,704,0,0
제20대,A486635H,안상수,安相洙,무소속,인천 중구동구강화군옹진군,572,29,543,11,25,5,0,2,126,4,399,0,0,2,3,1,0,0,5,0,18,0,0,9,22,4,0,2,121,4,381,0,0
제20대,U9G5099O,윤영일,尹英壹,국민의당,전남 해남군완도군진도군,1608,72,1536,54,77,18,0,3,399,17,1040,0,0,0,4,2,0,0,18,1,47,0,0,54,73,16,0,3,381,16,993,0,0
제20대,DAN6731C,박성중,朴成重,새누리당,서울 서초구을,728,50,678,16,28,9,1,1,191,4,478,0,0,0,0,0,0,0,12,1,37,0,0,16,28,9,1,1,179,3,441,0,0
제20대,UDB4825U,박주현,朴珠賢,국민의당,비례대표,956,76,880,37,21,16,0,8,207,3,664,0,0,1,1,6,0,5,21,0,42,0,0,36,20,10,0,3,186,3,622,0,0
제20대,TST4507I,안규백,安圭伯,더불어민주당,서울 동대문구갑,1462,76,1386,46,73,8,0,4,391,9,931,0,0,9,4,0,0,1,15,2,45,0,0,37,69,8,0,3,376,7,886,0,0
제20대,P303213F,정병국,鄭柄國,새누리당,경기 여주시양평군,603,57,546,15,13,4,0,0,116,7,448,0,0,0,0,0,0,0,13,2,42,0,0,15,13,4,0,0,103,5,406,0,0
제20대,0GF6251P,정유섭,鄭有燮,새누리당,인천 부평구갑,820,39,781,16,38,9,0,0,196,3,558,0,0,1,3,0,0,0,6,0,29,0,0,15,35,9,0,0,190,3,529,0,0
제20대,DQL3007B,정은혜,鄭恩惠,더불어민주당,비례대표,102,5,97,1,3,1,0,0,13,0,84,0,0,0,0,1,0,0,0,0,4,0,0,1,3,0,0,0,13,0,80,0,0
제20대,PP08673W,김경수,金慶洙,더불어민주당,경남 김해시을,280,53,227,8,6,3,0,0,64,1,198,0,0,1,1,0,0,0,13,0,38,0,0,7,5,3,0,0,51,1,160,0,0
제20대,F5U2979W,김학용,金學容,새누리당,경기 안성시,462,52,410,5,19,7,1,0,121,1,308,0,0,2,4,0,0,0,16,0,30,0,0,3,15,7,1,0,105,1,278,0,0
제20대,M0A1658U,윤호중,尹昊重,더불어민주당,경기 구리시,1034,66,968,25,44,15,0,4,240,6,700,0,0,1,0,1,0,1,19,1,43,0,0,24,44,14,0,3,221,5,657,0,0
제20대,25G2571T,전현희,全賢姬,더불어민주당,서울 강남구을,1001,143,858,38,47,10,0,1,254,6,645,0,0,3,8,0,0,0,33,0,99,0,0,35,39,10,0,1,221,6,546,0,0
제20대,U013741R,최명길,崔明吉,더불어민주당,서울 송파구을,444,35,409,3,11,7,0,3,95,4,321,0,0,0,1,0,0,0,10,0,24,0,0,3,10,7,0,3,85,4,297,0,0
제20대,KR14136C,홍영표,洪永杓,더불어민주당,인천 부평구을,420,35,385,4,15,5,0,1,114,2,279,0,0,0,2,0,0,0,14,0,19,0,0,4,13,5,0,1,100,2,260,0,0
제20대,GDG1847Z,권성동,權性東,새누리당,강원 강릉시,588,40,548,8,29,3,0,0,147,1,400,0,0,1,4,0,0,0,8,0,27,0,0,7,25,3,0,0,139,1,373,0,0
제20대,4019850M,박정,朴釘,더불어민주당,경기 파주시을,2811,228,2583,64,116,23,0,0,631,14,1963,0,0,6,13,0,0,0,50,3,156,0,0,58,103,23,0,0,581,11,1807,0,0
제20대,16I8621J,최연혜,崔然惠,새누리당,비례대표,654,51,603,21,29,6,0,0,163,4,431,0,0,4,4,0,0,0,7,2,34,0,0,17,25,6,0,0,156,2,397,0,0
제20대,MSY7784L,윤상현,尹相現,무소속,인천 남구을,276,28,248,4,11,4,0,0,54,1,202,0,0,0,1,0,0,0,8,1,18,0,0,4,10,4,0,0,46,0,184,0,0
제20대,Q6G2914I,윤종필,尹鍾畢,새누리당,비례대표,919,41,878,11,37,13,0,0,255,8,595,0,0,0,3,0,0,0,14,0,24,0,0,11,34,13,0,0,241,8,571,0,0
제20대,CXA6162I,김현아,金炫我,새누리당,비례대표,890,74,816,36,51,8,0,0,233,2,560,0,0,2,7,2,0,0,27,0,36,0,0,34,44,6,0,0,206,2,524,0,0
제20대,5CO4531H,유은혜,兪銀惠,더불어민주당,경기 고양시병,975,47,928,23,42,14,1,4,208,5,678,0,0,3,2,1,0,0,11,0,30,0,0,20,40,13,1,4,197,5,648,0,0
제20대,MD083627,정춘숙,鄭春淑,더불어민주당,비례대표,1341,149,1192,22,47,18,0,2,392,3,857,0,0,1,9,0,0,0,58,0,81,0,0,21,38,18,0,2,334,3,776,0,0
제20대,1Y73132H,김상훈,金相勳,새누리당,대구 서구,855,84,771,13,18,12,0,1,247,4,560,0,0,0,5,0,0,0,47,0,32,0,0,13,13,12,0,1,200,4,528,0,0
제20대,9UW75767,김성태,金成泰,새누리당,비례대표,534,27,507,8,19,6,0,1,124,4,372,0,0,1,1,0,0,0,7,0,18,0,0,7,18,6,0,1,117,4,354,0,0
제20대,4Y54669I,서청원,徐淸源,새누리당,경기 화성시갑,271,6,265,1,11,1,0,0,62,2,194,0,0,0,0,0,0,0,1,0,5,0,0,1,11,1,0,0,61,2,189,0,0
제20대,2XI97689,이종구,李鍾九,새누리당,서울 강남구갑,400,14,386,3,12,3,0,1,101,4,276,0,0,0,0,0,0,1,7,0,6,0,0,3,12,3,0,0,94,4,270,0,0
제20대,8IN46764,이주영,李柱榮,새누리당,경남 창원시마산합포구,307,35,272,5,15,1,0,0,73,1,212,0,0,0,3,1,0,0,4,0,27,0,0,5,12,0,0,0,69,1,185,0,0
제20대,C7Z8238W,황영철,黃永哲,새누리당,강원 홍천군철원군화천군양구군인제군,435,17,418,8,24,2,0,0,98,3,300,0,0,1,3,0,0,0,2,0,11,0,0,7,21,2,0,0,96,3,289,0,0
제20대,8Q88373R,김병기,金炳基,더불어민주당,서울 동작구갑,1572,81,1491,27,47,8,0,1,331,7,1151,0,0,1,0,1,0,0,15,0,64,0,0,26,47,7,0,1,316,7,1087,0,0
제20대,TVF3669B,김태흠,金泰欽,새누리당,충남 보령시서천군,694,36,658,41,42,4,0,1,179,1,426,0,0,3,3,0,0,1,10,0,19,0,0,38,39,4,0,0,169,1,407,0,0
제20대,0E97245Y,정양석,鄭亮碩,새누리당,서울 강북구갑,271,8,263,7,11,2,0,0,67,2,182,0,0,0,1,0,0,0,1,0,6,0,0,7,10,2,0,0,66,2,176,0,0
제20대,K1Y45873,김종태,金鍾泰,새누리당,경북 상주시군위군의성군청송군,124,10,114,2,6,1,0,0,43,2,70,0,0,0,0,0,0,0,3,2,5,0,0,2,6,1,0,0,40,0,65,0,0
제20대,TIS61927,양승조,梁承晁,더불어민주당,충남 천안시병,683,97,586,13,21,4,0,1,212,5,427,0,0,4,2,1,0,1,46,1,42,0,0,9,19,3,0,0,166,4,385,0,0
제20대,3249208I,송옥주,宋玉珠,더불어민주당,비례대표,1764,166,1598,34,69,8,0,2,403,10,1238,0,0,1,2,0,0,0,40,2,121,0,0,33,67,8,0,2,363,8,1117,0,0
제20대,OC037566,김규환,金奎煥,새누리당,비례대표,727,45,682,18,39,5,0,1,172,3,489,0,0,1,4,2,0,0,17,1,20,0,0,17,35,3,0,1,155,2,469,0,0
제20대,ZYP7962W,김석기,金碩基,새누리당,경북 경주시,1158,48,1110,28,44,23,1,1,277,8,776,0,0,2,1,1,0,0,5,0,39,0,0,26,43,22,1,1,272,8,737,0,0
제20대,TWL5801D,김영춘,金榮春,더불어민주당,부산 부산진구갑,686,49,637,18,32,5,0,1,133,3,494,0,0,2,2,0,0,0,6,1,38,0,0,16,30,5,0,1,127,2,456,0,0
제20대,QZU9232M,김재원,金在原,자유한국당,경북 상주시군위군의성군청송군,407,22,385,12,11,1,0,0,77,0,306,0,0,0,0,0,0,0,5,0,17,0,0,12,11,1,0,0,72,0,289,0,0
제20대,MO52543L,변재일,卞在一,더불어민주당,충북 청주시청원구,657,80,577,16,27,14,0,0,166,4,430,0,0,0,0,4,0,0,21,0,55,0,0,16,27,10,0,0,145,4,375,0,0
제20대,8FB1535Y,어기구,魚基龜,더불어민주당,충남 당진시,1002,60,942,13,46,7,0,1,212,8,715,0,0,0,1,0,0,0,10,1,48,0,0,13,45,7,0,1,202,7,667,0,0
제20대,9VR65006,윤영석,尹永碩,새누리당,경남 양산시갑,716,68,648,14,25,4,0,1,181,7,484,0,0,0,1,0,0,0,15,2,50,0,0,14,24,4,0,1,166,5,434,0,0
제20대,CDL93608,조응천,趙應天,더불어민주당,경기 남양주시갑,297,79,218,11,11,4,0,0,39,0,232,0,0,2,2,0,0,0,7,0,68,0,0,9,9,4,0,0,32,0,164,0,0
제20대,NNP30098,김기선,金起善,새누리당,강원 원주시갑,605,83,522,11,27,5,0,0,165,1,396,0,0,2,5,0,0,0,36,1,39,0,0,9,22,5,0,0,129,0,357,0,0
제20대,CI15627C,김두관,金斗官,더불어민주당,경기 김포시갑,740,44,696,18,23,6,0,0,172,4,517,0,0,0,0,1,0,0,10,0,33,0,0,18,23,5,0,0,162,4,484,0,0
제20대,GCA42857,주승용,朱昇鎔,국민의당,전남 여수시을,1576,154,1422,51,71,28,0,6,386,8,1026,0,0,9,6,3,0,0,52,4,80,0,0,42,65,25,0,6,334,4,946,0,0
제20대,8X15119P,윤한홍,尹漢洪,새누리당,경남 창원시마산회원구,523,43,480,18,25,9,0,0,130,3,338,0,0,2,1,5,0,0,6,0,29,0,0,16,24,4,0,0,124,3,309,0,0
제20대,0VU8517U,황희,黃熙,더불어민주당,서울 양천구갑,792,60,732,14,42,5,0,4,184,6,537,0,0,2,3,0,0,0,11,0,44,0,0,12,39,5,0,4,173,6,493,0,0
제20대,8I61593E,강석호,姜碩鎬,새누리당,경북 영양군영덕군봉화군울진군,581,43,538,22,23,6,0,1,137,3,389,0,0,0,1,0,0,0,8,1,33,0,0,22,22,6,0,1,129,2,356,0,0
제20대,ZRF3039U,윤재옥,尹在玉,새누리당,대구 달서구을,447,51,396,6,21,9,0,0,104,1,306,0,0,0,2,2,0,0,16,0,31,0,0,6,19,7,0,0,88,1,275,0,0
제20대,N6C1899K,김진태,金鎭台,새누리당,강원 춘천시,328,35,293,7,19,6,1,0,59,1,235,0,0,1,2,1,0,0,5,0,26,0,0,6,17,5,1,0,54,1,209,0,0
제20대,DBA1057Z,이용호,李容鎬,국민의당,전북 남원시임실군순창군,672,67,605,19,30,15,0,4,165,6,433,0,0,0,2,0,0,0,12,1,52,0,0,19,28,15,0,4,153,5,381,0,0
제20대,QKY38290,여상규,余尙奎,새누리당,경남 사천시남해군하동군,342,7,335,10,24,2,0,0,73,3,230,0,0,0,1,0,0,0,1,0,5,0,0,10,23,2,0,0,72,3,225,0,0
제20대,SSF6805Q,염동열,廉東烈,새누리당,강원 태백시횡성군영월군평창군정선군,496,42,454,19,26,9,0,0,118,2,322,0,0,2,7,1,0,0,9,0,23,0,0,17,19,8,0,0,109,2,299,0,0
제20대,AJV31724,이학재,李鶴宰,새누리당,인천 서구갑,579,41,538,20,28,6,0,3,156,1,365,0,0,3,2,0,0,0,13,0,23,0,0,17,26,6,0,3,143,1,342,0,0
제20대,EVH1507C,이헌승,李憲昇,새누리당,부산 부산진구을,431,62,369,12,20,7,0,0,99,3,290,0,0,2,8,1,0,0,28,0,23,0,0,10,12,6,0,0,71,3,267,0,0
제20대,EH27538E,임이자,林利子,새누리당,비례대표,914,105,809,22,42,9,0,0,239,2,600,0,0,7,4,3,0,0,39,0,52,0,0,15,38,6,0,0,200,2,548,0,0
제20대,CYD5815E,정갑윤,鄭甲潤,새누리당,울산 중구,1203,78,1125,20,51,10,0,1,288,4,829,0,0,0,2,0,0,1,23,0,52,0,0,20,49,10,0,0,265,4,777,0,0
제20대,7XY7109I,성일종,成一鍾,새누리당,충남 서산시태안군,1251,51,1200,40,49,6,0,1,338,11,806,0,0,1,0,0,0,0,15,0,35,0,0,39,49,6,0,1,323,11,771,0,0
제20대,ZA54991S,안민석,安敏錫,더불어민주당,경기 오산시,975,72,903,27,43,10,1,0,200,2,692,0,0,4,2,0,0,0,15,0,51,0,0,23,41,10,1,0,185,2,641,0,0
제20대,06571503,정태옥,鄭泰沃,새누리당,대구 북구갑,1098,62,1036,46,51,7,1,2,282,3,706,0,0,0,2,0,0,1,7,0,52,0,0,46,49,7,1,1,275,3,654,0,0
제20대,BT62420K,박찬대,朴贊大,더불어민주당,인천 연수구갑,1484,84,1400,26,53,8,0,1,256,3,1137,0,0,1,3,1,0,0,14,0,65,0,0,25,50,7,0,1,242,3,1072,0,0
제20대,9YO73104,전재수,田載秀,더불어민주당,부산 북구강서구갑,1357,123,1234,33,57,17,0,1,248,4,997,0,0,3,4,2,0,0,15,0,99,0,0,30,53,15,0,1,233,4,898,0,0
제20대,D0C85236,박완수,朴完洙,새누리당,경남 창원시의창구,494,67,427,6,22,3,0,0,130,2,331,0,0,1,1,0,0,0,7,0,58,0,0,5,21,3,0,0,123,2,273,0,0
제20대,RD42006Y,송갑석,宋甲錫,더불어민주당,광주 서구갑,996,59,937,29,38,13,0,0,168,2,746,0,0,2,1,2,0,0,8,0,46,0,0,27,37,11,0,0,160,2,700,0,0
제20대,O8E1566L,최도자,崔道子,국민의당,비례대표,1911,155,1756,43,65,20,0,4,475,15,1289,0,0,12,7,3,0,0,42,1,90,0,0,31,58,17,0,4,433,14,1199,0,0
제20대,DCR84445,김동철,金東喆,국민의당,광주 광산구갑,786,91,695,19,42,11,0,3,169,3,539,0,0,0,1,1,0,1,20,0,68,0,0,19,41,10,0,2,149,3,471,0,0
제20대,O6D8329R,민홍철,閔洪喆,더불어민주당,경남 김해시갑,1179,98,1081,26,69,12,0,1,284,3,784,0,0,2,11,0,0,0,29,0,56,0,0,24,58,12,0,1,255,3,728,0,0
제20대,06X3845L,김종석,金鍾奭,새누리당,비례대표,537,34,503,10,23,5,1,2,109,5,382,0,0,0,6,0,1,0,8,0,19,0,0,10,17,5,0,2,101,5,363,0,0
제20대,A8O42480,손금주,孫今柱,국민의당,전남 나주시화순군,701,85,616,59,34,10,0,4,172,6,416,0,0,3,5,0,0,0,13,0,64,0,0,56,29,10,0,4,159,6,352,0,0
제20대,V8I36226,장병완,張秉浣,국민의당,광주 동구남구갑,908,47,861,54,38,14,0,1,198,2,601,0,0,2,5,0,0,0,5,1,34,0,0,52,33,14,0,1,193,1,567,0,0
제20대,VNF2868Z,조원진,趙源震,새누리당,대구 달서구병,137,19,118,2,7,2,0,0,38,1,87,0,0,0,1,1,0,0,1,0,16,0,0,2,6,1,0,0,37,1,71,0,0
제20대,60490713,강병원,姜炳遠,더불어민주당,서울 은평구을,1077,94,983,23,35,8,0,1,288,11,711,0,0,2,1,0,0,0,35,0,56,0,0,21,34,8,0,1,253,11,655,0,0
제20대,9EA39580,김명연,金明淵,새누리당,경기 안산시단원구갑,784,76,708,17,31,10,0,1,237,6,482,0,0,0,5,0,0,0,17,2,52,0,0,17,26,10,0,1,220,4,430,0,0
제20대,GN240959,노회찬,魯會燦,정의당,경남 창원시성산구,400,57,343,1,4,5,0,6,88,1,295,0,0,0,2,1,0,5,11,0,38,0,0,1,2,4,0,1,77,1,257,0,0
제20대,Y3E8697I,민경욱,閔庚旭,새누리당,인천 연수구을,737,102,635,18,27,5,0,0,170,4,513,0,0,1,4,1,0,0,30,1,65,0,0,17,23,4,0,0,140,3,448,0,0
제20대,TKJ4800F,서영교,徐瑛敎,더불어민주당,서울 중랑구갑,1834,151,1683,45,71,10,0,2,418,13,1275,0,0,3,2,1,0,0,18,1,126,0,0,42,69,9,0,2,400,12,1149,0,0
제20대,FGX4881A,심재철,沈在哲,새누리당,경기 안양시동안구을,319,77,242,2,8,7,0,0,51,1,250,0,0,1,0,1,0,0,9,0,66,0,0,1,8,6,0,0,42,1,184,0,0
제20대,JMY9959W,윤관석,尹官石,더불어민주당,인천 남동구을,2378,74,2304,78,125,26,0,6,630,10,1503,0,0,3,9,1,0,0,25,0,36,0,0,75,116,25,0,6,605,10,1467,0,0
제20대,9LD2641Q,김정호,金禎鎬,더불어민주당,경남 김해시을,389,42,347,2,13,3,0,0,71,0,300,0,0,0,0,0,0,0,5,0,37,0,0,2,13,3,0,0,66,0,263,0,0
제20대,MPV9321A,김현권,金玄權,더불어민주당,비례대표,1650,87,1563,59,82,17,0,2,394,1,1095,0,0,6,8,0,0,0,39,0,34,0,0,53,74,17,0,2,355,1,1061,0,0
제20대,VE469451,최재성,崔宰誠,더불어민주당,서울 송파구을,430,27,403,5,10,8,0,0,53,2,352,0,0,0,0,0,0,0,1,0,26,0,0,5,10,8,0,0,52,2,326,0,0
제20대,MRK4871S,유의동,兪義東,새누리당,경기 평택시을,376,37,339,15,8,1,0,1,75,1,275,0,0,1,0,0,0,0,6,0,30,0,0,14,8,1,0,1,69,1,245,0,0
제20대,8SV6917G,주호영,朱豪英,무소속,대구 수성구을,735,69,666,16,37,3,0,0,196,3,480,0,0,0,3,0,0,0,15,0,51,0,0,16,34,3,0,0,181,3,429,0,0
제20대,ARP89147,정동영,鄭東泳,국민의당,전북 전주시병,1456,70,1386,34,36,25,0,3,270,11,1077,0,0,0,1,1,0,0,8,0,60,0,0,34,35,24,0,3,262,11,1017,0,0
제20대,06L2365K,홍일표,洪日杓,새누리당,인천 남구갑,280,23,257,8,12,1,0,0,68,1,190,0,0,0,1,0,0,0,7,0,15,0,0,8,11,1,0,0,61,1,175,0,0
제20대,6V37131U,고용진,高榕진,더불어민주당,서울 노원구갑,1284,78,1206,53,55,17,0,5,273,9,872,0,0,3,1,0,0,1,15,0,58,0,0,50,54,17,0,4,258,9,814,0,0
제20대,WV97281W,문진국,文鎭國,새누리당,비례대표,1004,51,953,31,50,7,0,0,261,4,651,0,0,1,4,0,0,0,18,0,28,0,0,30,46,7,0,0,243,4,623,0,0
제20대,0827740Q,노웅래,盧雄來,더불어민주당,서울 마포구갑,1943,148,1795,43,82,19,0,2,422,15,1360,0,0,3,9,1,0,0,27,0,108,0,0,40,73,18,0,2,395,15,1252,0,0
제20대,XT18076X,박주선,朴柱宣,국민의당,광주 동구남구을,568,19,549,10,16,8,0,1,131,5,397,0,0,0,0,1,0,0,4,0,14,0,0,10,16,7,0,1,127,5,383,0,0
제20대,CNW5754J,송석준,宋錫俊,새누리당,경기 이천시,462,45,417,7,26,8,0,0,128,2,291,0,0,0,1,0,0,0,16,0,28,0,0,7,25,8,0,0,112,2,263,0,0
제20대,BM63269Y,전해철,全海澈,더불어민주당,경기 안산시상록구갑,648,60,588,21,18,3,0,0,99,2,505,0,0,1,3,0,0,0,10,0,46,0,0,20,15,3,0,0,89,2,459,0,0
제20대,FYI20317,조승래,趙承來,더불어민주당,대전 유성구갑,1192,72,1120,28,68,18,0,1,258,5,814,0,0,8,4,0,0,0,22,0,38,0,0,20,64,18,0,1,236,5,776,0,0
제20대,G152611B,추경호,秋慶鎬,새누리당,대구 달성군,1168,111,1057,23,36,7,1,3,348,1,749,0,0,2,2,2,0,2,54,0,49,0,0,21,34,5,1,1,294,1,700,0,0
제20대,C7E79345,권칠승,權七勝,더불어민주당,경기 화성시병,1827,119,1708,50,52,20,1,4,431,10,1259,0,0,4,3,0,0,0,22,0,90,0,0,46,49,20,1,4,409,10,1169,0,0
제20대,9XB6464U,김현미,金賢美,더불어민주당,경기 고양시정,466,29,437,7,16,10,0,4,101,2,326,0,0,0,0,1,0,1,7,0,20,0,0,7,16,9,0,3,94,2,306,0,0
