대수,국회의원코드,국회의원명,국회의원한자명,정당명,선거구명,발의수(전체),발의수(대표발의),발의수(공동발의),원안가결(전체),수정가결(전체),철회(전체),부결(전체),수정안반영폐기(전체),대안반영폐기(전체),폐기(전체),임기만료폐기(전체),회기불계속폐기(전체),기타(전체),원안가결(대표발의),수정가결(대표발의),철회(대표발의),부결(대표발의),수정안반영폐기(대표발의),대안반영폐기(대표발의),폐기(대표발의),임기만료폐기(대표발의),회기불계속폐기(대표발의),기타,원안가결(공동발의),수정가결(공동발의),철회(공동발의),부결(공동발의),수정안반영폐기(공동발의),대안반영폐기(공동발의),폐기(공동발의),임기만료폐기(공동발의),회기불계속폐기(공동발의),기타(공동발의)
제21대,6RD62559,박정하,朴正河,국민의힘,강원 원주시갑,342,18,324,5,30,2,0,9,84,0,212,0,0,0,3,0,0,0,4,0,11,0,0,5,27,2,0,9,80,0,201,0,0
제21대,9S151177,이탄희,李誕熙,더불어민주당,경기 용인시정,785,65,720,10,33,11,0,2,209,8,512,0,0,0,0,3,0,0,13,1,48,0,0,10,33,8,0,2,196,7,464,0,0
제21대,6V37131U,고용진,高榕진,더불어민주당,서울 노원구갑,893,64,829,7,39,8,0,24,256,3,556,0,0,2,2,1,0,8,27,0,24,0,0,5,37,7,0,16,229,3,532,0,0
제21대,0W194007,김영주,金榮珠,더불어민주당,서울 영등포구갑,657,107,550,6,41,8,0,2,155,0,445,0,0,1,3,2,0,0,26,0,75,0,0,5,38,6,0,2,129,0,370,0,0
제21대,0827740Q,노웅래,盧雄來,더불어민주당,서울 마포구갑,928,108,820,11,62,8,0,7,241,4,595,0,0,1,9,1,0,0,34,0,63,0,0,10,53,7,0,7,207,4,532,0,0
제21대,TKJ4800F,서영교,徐瑛敎,더불어민주당,서울 중랑구갑,1479,170,1309,20,55,28,0,8,403,3,962,0,0,2,4,1,0,2,85,0,76,0,0,18,51,27,0,6,318,3,886,0,0
제21대,KNM3215T,윤미향,尹美香,더불어시민당,비례대표,1452,115,1337,18,55,7,0,1,358,7,1006,0,0,0,2,0,0,0,16,0,97,0,0,18,53,7,0,1,342,7,909,0,0
제21대,3C23171A,진성준,陳聲準,더불어민주당,서울 강서구을,961,82,879,26,51,5,0,3,229,0,647,0,0,0,4,0,0,0,18,0,60,0,0,26,47,5,0,3,211,0,587,0,0
제21대,6FS10566,강성희,姜聖熙,진보당,전북 전주시을,91,11,80,0,1,0,0,0,7,0,83,0,0,0,0,0,0,0,0,0,11,0,0,0,1,0,0,0,7,0,72,0,0
제21대,04T3751T,남인순,南仁順,더불어민주당,서울 송파구병,1158,83,1075,22,72,7,0,0,293,0,764,0,0,0,8,0,0,0,33,0,42,0,0,22,64,7,0,0,260,0,722,0,0
제21대,BLC8630L,박병석,朴炳錫,더불어민주당,대전 서구갑,27,7,20,0,1,1,0,0,4,0,21,0,0,0,0,0,0,0,2,0,5,0,0,0,1,1,0,0,2,0,16,0,0
제21대,ZDR63255,소병훈,蘇秉勳,더불어민주당,경기 광주시갑,1007,108,899,10,69,16,0,2,219,4,687,0,0,0,8,4,0,0,19,1,76,0,0,10,61,12,0,2,200,3,611,0,0
제21대,KUO3574J,양기대,梁基大,더불어민주당,경기 광명시을,825,52,773,6,34,6,0,10,237,3,529,0,0,0,1,0,0,0,5,0,46,0,0,6,33,6,0,10,232,3,483,0,0
제21대,DWK26447,이인선,李仁善,국민의힘,대구 수성구을,536,21,515,8,20,1,0,9,110,0,388,0,0,0,2,0,0,0,5,0,14,0,0,8,18,1,0,9,105,0,374,0,0
제21대,1Y73132H,김상훈,金相勳,미래통합당,대구 서구,988,76,912,15,51,8,0,45,286,7,576,0,0,0,6,1,0,11,26,0,32,0,0,15,45,7,0,34,260,7,544,0,0
제21대,UGH6481E,김상희,金相姬,더불어민주당,경기 부천시병,775,99,676,7,40,5,0,1,171,1,550,0,0,1,4,0,0,0,13,0,81,0,0,6,36,5,0,1,158,1,469,0,0
제21대,FU87526G,박수영,朴洙瑩,미래통합당,부산 남구갑,363,38,325,1,22,3,0,9,95,4,229,0,0,0,0,0,0,0,13,0,25,0,0,1,22,3,0,9,82,4,204,0,0
제21대,3DK8989T,최춘식,崔春植,미래통합당,경기 포천시가평군,1148,53,1095,12,47,10,0,24,275,2,778,0,0,0,2,1,0,0,14,0,36,0,0,12,45,9,0,24,261,2,742,0,0
제21대,XJC13432,태영호,太永浩,미래통합당,서울 강남구갑,1659,111,1548,20,52,20,0,18,396,10,1143,0,0,2,2,1,0,2,19,0,85,0,0,18,50,19,0,16,377,10,1058,0,0
제21대,X7I4680R,김기현,金起炫,미래통합당,울산 남구을,602,44,558,4,30,8,0,5,191,9,355,0,0,0,0,1,0,2,9,0,32,0,0,4,30,7,0,3,182,9,323,0,0
제21대,MR210505,서일준,徐一俊,미래통합당,경남 거제시,1512,120,1392,17,60,15,0,22,423,7,968,0,0,0,6,1,0,4,31,2,76,0,0,17,54,14,0,18,392,5,892,0,0
제21대,O7R5461J,윤후덕,尹厚德,더불어민주당,경기 파주시갑,1123,83,1040,15,52,19,0,18,294,8,717,0,0,1,0,2,0,1,15,0,64,0,0,14,52,17,0,17,279,8,653,0,0
제21대,21N57758,오영훈,吳怜勳,더불어민주당,제주 제주시을,388,41,347,5,23,2,0,0,104,4,250,0,0,0,1,0,0,0,15,0,25,0,0,5,22,2,0,0,89,4,225,0,0
제21대,NZF1659U,정운천,鄭雲天,미래통합당,비례대표,1096,50,1046,21,46,8,0,17,279,7,718,0,0,0,2,0,0,1,13,0,34,0,0,21,44,8,0,16,266,7,684,0,0
제21대,66W6739S,허은아,許垠娥,미래한국당,비례대표,583,38,545,11,27,4,0,3,172,5,361,0,0,2,2,0,0,0,16,0,18,0,0,9,25,4,0,3,156,5,343,0,0
제21대,C835799S,김근태,金僅泰,국민의힘,비례대표,20,3,17,0,0,0,0,0,0,0,20,0,0,0,0,0,0,0,0,0,3,0,0,0,0,0,0,0,0,0,17,0,0
제21대,MSO2590I,김은희,金恩希,국민의힘,비례대표,43,12,31,0,0,0,0,0,1,0,42,0,0,0,0,0,0,0,0,0,12,0,0,0,0,0,0,0,1,0,30,0,0
제21대,6U243644,박형수,朴亨修,미래통합당,경북 영주시영양군봉화군울진군,370,40,330,8,18,6,0,5,85,0,248,0,0,1,2,0,0,0,9,0,28,0,0,7,16,6,0,5,76,0,220,0,0
제21대,YOG1280B,안철수,安哲秀,국민의힘,경기 성남시분당구갑,186,13,173,1,9,1,0,1,26,0,148,0,0,0,0,0,0,0,3,0,10,0,0,1,9,1,0,1,23,0,138,0,0
제21대,IOW8224X,이형석,李炯錫,더불어민주당,광주 북구을,1230,75,1155,10,65,15,0,6,329,6,799,0,0,0,3,0,0,0,35,0,37,0,0,10,62,15,0,6,294,6,762,0,0
제21대,9YO73104,전재수,田載秀,더불어민주당,부산 북구강서구갑,831,84,747,4,40,8,0,7,217,5,550,0,0,0,3,2,0,1,24,0,54,0,0,4,37,6,0,6,193,5,496,0,0
제21대,YLS4431M,조수진,趙修眞,미래한국당,비례대표,972,33,939,11,36,6,0,21,241,10,647,0,0,0,0,0,0,2,3,0,28,0,0,11,36,6,0,19,238,10,619,0,0
제21대,0YT3774N,황운하,黃雲夏,더불어민주당,대전 중구,1675,77,1598,23,67,16,0,2,398,7,1162,0,0,0,3,1,0,0,5,0,68,0,0,23,64,15,0,2,393,7,1094,0,0
제21대,LG63087O,권영세,權寧世,미래통합당,서울 용산구,494,34,460,7,22,6,0,1,124,1,333,0,0,0,0,0,0,0,8,0,26,0,0,7,22,6,0,1,116,1,307,0,0
제21대,8Q88373R,김병기,金炳基,더불어민주당,서울 동작구갑,922,57,865,12,49,1,0,5,216,2,637,0,0,0,0,0,0,0,12,0,45,0,0,12,49,1,0,5,204,2,592,0,0
제21대,GOC54665,문정복,文貞福,더불어민주당,경기 시흥시갑,736,33,703,4,34,8,0,1,171,2,516,0,0,0,2,2,0,0,6,0,23,0,0,4,32,6,0,1,165,2,493,0,0
제21대,WVU2479T,이상헌,李相憲,더불어민주당,울산 북구,1493,108,1385,25,86,22,0,17,349,3,991,0,0,0,7,0,0,1,24,0,76,0,0,25,79,22,0,16,325,3,915,0,0
제21대,CDL93608,조응천,趙應天,더불어민주당,경기 남양주시갑,390,81,309,8,42,0,0,0,120,2,218,0,0,4,8,0,0,0,26,0,43,0,0,4,34,0,0,0,94,2,175,0,0
제21대,X1K3667J,김교흥,金敎興,더불어민주당,인천 서구갑,806,73,733,15,55,5,0,19,223,4,485,0,0,3,8,0,0,0,31,0,31,0,0,12,47,5,0,19,192,4,454,0,0
제21대,40S1959J,박영순,朴英淳,더불어민주당,대전 대덕구,985,67,918,17,61,3,0,2,281,3,618,0,0,0,9,0,0,0,17,1,40,0,0,17,52,3,0,2,264,2,578,0,0
제21대,OSV9142K,이만희,李晩熙,미래통합당,경북 영천시청도군,427,73,354,14,27,6,0,5,128,0,247,0,0,0,6,2,0,0,24,0,41,0,0,14,21,4,0,5,104,0,206,0,0
제21대,8FC9697X,유기홍,柳基洪,더불어민주당,서울 관악구갑,392,56,336,4,25,1,0,2,101,0,259,0,0,0,2,0,0,0,19,0,35,0,0,4,23,1,0,2,82,0,224,0,0
제21대,K5F2023J,이학영,李學永,더불어민주당,경기 군포시,1295,89,1206,18,62,9,0,2,301,4,899,0,0,2,1,1,0,0,11,0,74,0,0,16,61,8,0,2,290,4,825,0,0
제21대,2385336L,정청래,鄭淸來,더불어민주당,서울 마포구을,724,176,548,32,31,8,0,1,171,5,476,0,0,5,1,4,0,0,40,2,124,0,0,27,30,4,0,1,131,3,352,0,0
제21대,GFF1986K,김병욱,金炳旭,더불어민주당,경기 성남시분당구을,2786,172,2614,20,115,24,0,31,712,13,1871,0,0,2,5,2,0,5,49,1,108,0,0,18,110,22,0,26,663,12,1763,0,0
제21대,GF286398,김병주,金柄周,더불어시민당,비례대표,541,43,498,28,25,1,0,2,117,2,366,0,0,7,2,0,0,0,9,0,25,0,0,21,23,1,0,2,108,2,341,0,0
제21대,P2N4585G,김승남,金承南,더불어민주당,전남 고흥군보성군장흥군강진군,1486,120,1366,9,83,10,0,5,328,2,1049,0,0,1,10,3,0,1,33,0,72,0,0,8,73,7,0,4,295,2,977,0,0
제21대,6399076T,김민철,金敏徹,더불어민주당,경기 의정부시을,1598,69,1529,42,69,27,0,5,414,7,1034,0,0,2,3,0,0,0,20,1,43,0,0,40,66,27,0,5,394,6,991,0,0
제21대,S9U45255,이양수,李亮壽,미래통합당,강원 속초시인제군고성군양양군,500,48,452,6,39,5,0,7,127,1,315,0,0,1,11,0,0,1,9,0,26,0,0,5,28,5,0,6,118,1,289,0,0
제21대,XPP2564T,한정애,韓貞愛,더불어민주당,서울 강서구병,567,94,473,4,26,3,0,0,123,1,410,0,0,0,8,0,0,0,30,1,55,0,0,4,18,3,0,0,93,0,355,0,0
제21대,GE71932C,용혜인,龍慧仁,기본소득당,비례대표,783,37,746,6,11,8,0,4,138,1,615,0,0,0,0,0,0,0,2,0,35,0,0,6,11,8,0,4,136,1,580,0,0
제21대,8VJ8533R,최연숙,崔姸淑,국민의당,비례대표,507,72,435,3,22,3,0,2,93,1,383,0,0,0,7,0,0,0,17,0,48,0,0,3,15,3,0,2,76,1,335,0,0
제21대,OW53107J,설훈,薛勳,더불어민주당,경기 부천시을,479,57,422,9,23,3,0,3,105,1,335,0,0,3,2,1,0,0,9,0,42,0,0,6,21,2,0,3,96,1,293,0,0
제21대,SQ36001H,송기헌,宋基憲,더불어민주당,강원 원주시을,465,85,380,12,37,2,0,8,105,7,294,0,0,2,6,0,0,0,13,2,62,0,0,10,31,2,0,8,92,5,232,0,0
제21대,6MO8786S,안병길,安炳吉,미래통합당,부산 서구동구,987,123,864,16,37,10,0,12,221,6,685,0,0,4,4,0,0,0,15,1,99,0,0,12,33,10,0,12,206,5,586,0,0
제21대,MRK4871S,유의동,兪義東,미래통합당,경기 평택시을,535,59,476,7,25,4,0,2,117,3,377,0,0,0,5,0,0,0,14,0,40,0,0,7,20,4,0,2,103,3,337,0,0
제21대,VHK3402G,정우택,鄭宇澤,국민의힘,충북 청주시상당구,669,68,601,5,33,3,0,20,151,1,456,0,0,1,4,0,0,1,19,1,42,0,0,4,29,3,0,19,132,0,414,0,0
제21대,60490713,강병원,姜炳遠,더불어민주당,서울 은평구을,1042,104,938,11,47,10,0,6,270,4,694,0,0,0,0,1,0,0,34,0,69,0,0,11,47,9,0,6,236,4,625,0,0
제21대,QQP4727N,배준영,裵俊英,미래통합당,인천 중구강화군옹진군,794,71,723,17,36,15,0,37,196,4,489,0,0,1,2,4,0,19,14,0,31,0,0,16,34,11,0,18,182,4,458,0,0
제21대,XR24352K,서영석,徐暎錫,더불어민주당,경기 부천시정,1329,85,1244,36,68,14,0,5,332,5,869,0,0,3,5,0,0,0,27,0,50,0,0,33,63,14,0,5,305,5,819,0,0
제21대,F5Y4026Q,신현영,申賢榮,더불어시민당,비례대표,546,111,435,24,29,0,0,5,128,1,359,0,0,1,4,0,0,0,34,0,72,0,0,23,25,0,0,5,94,1,287,0,0
제21대,YTA7297R,최영희,崔英姬,국민의힘,비례대표,560,25,535,4,27,2,0,5,128,0,394,0,0,1,3,0,0,0,5,0,16,0,0,3,24,2,0,5,123,0,378,0,0
제21대,FGI27280,하영제,河榮帝,미래통합당,경남 사천시남해군하동군,1140,89,1051,9,61,13,0,12,264,7,774,0,0,0,0,0,0,0,18,1,70,0,0,9,61,13,0,12,246,6,704,0,0
제21대,7I09543O,이장섭,李將燮,더불어민주당,충북 청주시서원구,919,64,855,13,61,9,0,3,216,6,611,0,0,2,6,0,0,1,13,0,42,0,0,11,55,9,0,2,203,6,569,0,0
제21대,BM63269Y,전해철,全海澈,더불어민주당,경기 안산시상록구갑,327,49,278,2,25,8,0,0,58,0,234,0,0,0,5,1,0,0,7,0,36,0,0,2,20,7,0,0,51,0,198,0,0
제21대,5KV82250,조경태,趙慶泰,미래통합당,부산 사하구을,801,75,726,10,30,6,0,7,205,8,535,0,0,2,5,1,0,0,14,2,51,0,0,8,25,5,0,7,191,6,484,0,0
제21대,P2N50879,강민정,姜旼姃,열린민주당,비례대표,1689,126,1563,6,36,12,0,3,316,3,1313,0,0,0,0,5,0,0,15,0,106,0,0,6,36,7,0,3,301,3,1207,0,0
제21대,8X15119P,윤한홍,尹漢洪,미래통합당,경남 창원시마산회원구,659,40,619,6,27,7,0,2,175,3,439,0,0,2,1,0,0,0,18,0,19,0,0,4,26,7,0,2,157,3,420,0,0
제21대,DBA1057Z,이용호,李容鎬,무소속,전북 남원시임실군순창군,567,82,485,7,35,5,0,4,135,0,381,0,0,0,4,1,0,1,17,0,59,0,0,7,31,4,0,3,118,0,322,0,0
제21대,USR7059P,정경희,丁慶姬,미래한국당,비례대표,479,49,430,5,20,2,0,7,107,8,330,0,0,1,0,0,0,0,8,0,40,0,0,4,20,2,0,7,99,8,290,0,0
제21대,LJK4960Z,정점식,鄭点植,미래통합당,경남 통영시고성군,370,69,301,7,26,4,0,5,102,4,222,0,0,3,10,1,0,1,22,0,32,0,0,4,16,3,0,4,80,4,190,0,0
제21대,68P7228G,진선미,陳善美,더불어민주당,서울 강동구갑,452,80,372,9,25,3,0,0,122,1,292,0,0,1,5,1,0,0,16,0,57,0,0,8,20,2,0,0,106,1,235,0,0
제21대,8348421R,엄태영,嚴泰永,미래통합당,충북 제천시단양군,868,59,809,21,34,10,0,5,220,7,571,0,0,0,0,1,0,0,4,0,54,0,0,21,34,9,0,5,216,7,517,0,0
제21대,RO593601,이동주,李東洲,더불어시민당,비례대표,1477,81,1396,15,52,5,0,8,321,2,1074,0,0,0,1,0,0,0,9,0,71,0,0,15,51,5,0,8,312,2,1003,0,0
제21대,D4L60530,이수진,李秀眞,더불어민주당,서울 동작구을,1351,101,1250,33,73,18,0,5,342,5,875,0,0,2,3,0,0,0,13,0,83,0,0,31,70,18,0,5,329,5,792,0,0
제21대,ZYH1940A,이상민,李相珉,더불어민주당,대전 유성구을,249,32,217,2,17,2,0,0,64,2,162,0,0,0,3,0,0,0,5,0,24,0,0,2,14,2,0,0,59,2,138,0,0
제21대,CZB4125D,장제원,張濟元,미래통합당,부산 사상구,254,53,201,6,8,4,0,0,64,1,171,0,0,0,1,2,0,0,10,0,40,0,0,6,7,2,0,0,54,1,131,0,0
제21대,UQ282145,이재정,李在汀,더불어민주당,경기 안양시동안구을,408,55,353,7,21,2,0,2,104,2,270,0,0,1,2,0,0,0,9,0,43,0,0,6,19,2,0,2,95,2,227,0,0
제21대,HSW1214Q,이종배,李鍾培,미래통합당,충북 충주시,1293,149,1144,13,51,17,0,24,343,5,840,0,0,1,4,3,0,3,25,0,113,0,0,12,47,14,0,21,318,5,727,0,0
제21대,P0F1530P,김태호,金台鎬,무소속,경남 산청군함양군거창군합천군,614,22,592,11,21,7,0,3,163,2,407,0,0,0,0,1,0,0,4,1,16,0,0,11,21,6,0,3,159,1,391,0,0
제21대,WFU14784,서정숙,徐正淑,미래한국당,비례대표,587,48,539,9,25,6,0,2,140,3,402,0,0,0,2,0,0,0,19,0,27,0,0,9,23,6,0,2,121,3,375,0,0
제21대,9JF4562W,이용선,李庸瑄,더불어민주당,서울 양천구을,887,59,828,11,41,6,0,6,203,0,620,0,0,0,1,1,0,0,7,0,50,0,0,11,40,5,0,6,196,0,570,0,0
제21대,8VY63414,류성걸,柳性杰,미래통합당,대구 동구갑,627,87,540,10,25,4,0,13,155,3,417,0,0,3,4,1,0,8,22,0,49,0,0,7,21,3,0,5,133,3,368,0,0
제21대,D0C85236,박완수,朴完洙,미래통합당,경남 창원시의창구,265,53,212,4,14,2,0,7,65,1,172,0,0,2,2,0,0,0,18,1,30,0,0,2,12,2,0,7,47,0,142,0,0
제21대,A494529E,천준호,千俊鎬,더불어민주당,서울 강북구갑,476,43,433,2,36,4,0,5,136,3,290,0,0,0,3,0,0,0,17,0,23,0,0,2,33,4,0,5,119,3,267,0,0
제21대,YKW37422,권은희,權垠希,국민의당,비례대표,259,24,235,0,16,4,0,0,68,1,170,0,0,0,0,0,0,0,8,1,15,0,0,0,16,4,0,0,60,0,155,0,0
제21대,6AU2417B,박주민,朴柱民,더불어민주당,서울 은평구갑,480,141,339,16,29,1,0,0,67,0,367,0,0,1,3,0,0,0,25,0,112,0,0,15,26,1,0,0,42,0,255,0,0
제21대,FU53642G,허영,許榮,더불어민주당,강원 춘천시철원군화천군양구군갑,1498,91,1407,22,90,10,0,2,415,4,955,0,0,0,6,1,0,1,17,0,66,0,0,22,84,9,0,1,398,4,889,0,0
제21대,MQU41854,조은희,趙恩禧,국민의힘,서울 서초구갑,342,42,300,4,25,3,0,14,72,0,224,0,0,0,4,0,0,0,9,0,29,0,0,4,21,3,0,14,63,0,195,0,0
제21대,MLH1404S,김민석,金民錫,더불어민주당,서울 영등포구을,901,86,815,7,47,7,0,11,221,2,606,0,0,2,3,1,0,0,28,0,52,0,0,5,44,6,0,11,193,2,554,0,0
제21대,SVH3899R,김용판,金用判,미래통합당,대구 달서구병,2302,132,2170,25,105,16,0,38,593,12,1513,0,0,0,6,0,0,8,32,0,86,0,0,25,99,16,0,30,561,12,1427,0,0
제21대,QUO78839,박재호,朴在昊,더불어민주당,부산 남구을,774,93,681,12,40,6,0,4,232,4,476,0,0,6,3,1,0,0,25,0,58,0,0,6,37,5,0,4,207,4,418,0,0
제21대,PZA4062H,양정숙,梁貞淑,무소속,비례대표,2959,163,2796,38,113,36,0,16,707,10,2039,0,0,0,1,1,0,0,26,1,134,0,0,38,112,35,0,16,681,9,1905,0,0
제21대,9L57027L,유경준,兪京濬,미래통합당,서울 강남구병,975,67,908,6,52,9,0,17,259,6,626,0,0,0,1,2,0,2,24,0,38,0,0,6,51,7,0,15,235,6,588,0,0
제21대,ZDP5704Q,윤주경,尹柱卿,미래한국당,비례대표,502,53,449,5,16,3,0,3,134,3,338,0,0,0,1,0,0,0,10,0,42,0,0,5,15,3,0,3,124,3,296,0,0
제21대,EH27538E,임이자,林利子,미래통합당,경북 상주시문경시,1070,133,937,10,47,9,0,10,325,12,657,0,0,1,7,0,0,0,66,0,59,0,0,9,40,9,0,10,259,12,598,0,0
제21대,GAV6441G,장혜영,張惠英,정의당,비례대표,589,45,544,1,9,4,0,0,110,1,464,0,0,0,0,0,0,0,6,0,39,0,0,1,9,4,0,0,104,1,425,0,0
제21대,XSP20229,김성환,金星煥,더불어민주당,서울 노원구병,675,28,647,5,31,15,0,15,139,1,469,0,0,1,4,0,0,1,5,0,17,0,0,4,27,15,0,14,134,1,452,0,0
제21대,4U29186R,문진석,文振碩,더불어민주당,충남 천안시갑,1366,67,1299,17,73,13,0,7,389,6,861,0,0,0,1,0,0,3,23,0,40,0,0,17,72,13,0,4,366,6,821,0,0
제21대,A2V51235,배진교,裵晋敎,정의당,비례대표,635,38,597,2,11,4,0,0,120,1,497,0,0,0,0,1,0,0,7,0,30,0,0,2,11,3,0,0,113,1,467,0,0
제21대,LH97552Q,김도읍,金度邑,미래통합당,부산 북구강서구을,811,164,647,19,39,7,0,4,195,8,539,0,0,4,8,0,0,0,29,3,120,0,0,15,31,7,0,4,166,5,419,0,0
제21대,FIC9046Z,김의겸,金宜謙,열린민주당,비례대표,605,24,581,2,20,0,0,2,82,0,499,0,0,0,0,0,0,0,2,0,22,0,0,2,20,0,0,2,80,0,477,0,0
제21대,40E3739H,윤창현,尹暢賢,미래한국당,비례대표,1222,81,1141,15,41,5,0,22,360,10,769,0,0,0,3,0,0,0,23,0,55,0,0,15,38,5,0,22,337,10,714,0,0
제21대,ZRF3039U,윤재옥,尹在玉,미래통합당,대구 달서구을,396,77,319,7,21,6,0,11,116,4,231,0,0,1,8,0,0,0,24,0,44,0,0,6,13,6,0,11,92,4,187,0,0
제21대,WDS6044S,이채익,李埰益,미래통합당,울산 남구갑,933,70,863,15,40,10,0,15,219,2,632,0,0,0,2,0,0,0,20,0,48,0,0,15,38,10,0,15,199,2,584,0,0
제21대,I0S53762,하태경,河泰慶,미래통합당,부산 해운대구갑,334,58,276,0,9,6,0,1,75,1,242,0,0,0,3,1,0,0,6,1,47,0,0,0,6,5,0,1,69,0,195,0,0
제21대,TVF3669B,김태흠,金泰欽,미래통합당,충남 보령시서천군,426,21,405,4,17,6,0,2,109,5,283,0,0,0,0,0,0,0,4,0,17,0,0,4,17,6,0,2,105,5,266,0,0
제21대,WHV3448W,양향자,梁香子,더불어민주당,광주 서구을,836,45,791,9,45,10,0,11,235,2,524,0,0,0,1,0,0,1,11,1,31,0,0,9,44,10,0,10,224,1,493,0,0
제21대,OIA3741M,오기형,吳奇炯,더불어민주당,서울 도봉구을,229,23,206,5,15,0,0,2,61,1,145,0,0,0,1,0,0,0,6,0,16,0,0,5,14,0,0,2,55,1,129,0,0
제21대,7R156073,박범계,朴範界,더불어민주당,대전 서구을,157,32,125,13,23,1,0,0,35,3,82,0,0,2,3,0,0,0,6,0,21,0,0,11,20,1,0,0,29,3,61,0,0
제21대,0PK7354M,서동용,徐東榕,더불어민주당,전남 순천시광양시곡성군구례군을,1182,86,1096,10,61,9,0,14,263,4,821,0,0,2,6,0,0,0,25,0,53,0,0,8,55,9,0,14,238,4,768,0,0
제21대,SU53086M,심상정,沈相정,정의당,경기 고양시갑,663,62,601,2,7,8,0,1,117,0,528,0,0,0,1,1,0,0,13,0,47,0,0,2,6,7,0,1,104,0,481,0,0
제21대,I434361W,조태용,趙太庸,미래한국당,비례대표,218,15,203,2,5,2,0,0,53,1,155,0,0,1,1,0,0,0,1,0,12,0,0,1,4,2,0,0,52,1,143,0,0
제21대,MNZ4401T,강선우,姜仙祐,더불어민주당,서울 강서구갑,1254,133,1121,21,84,11,0,4,328,2,804,0,0,3,12,3,0,0,32,0,83,0,0,18,72,8,0,4,296,2,721,0,0
제21대,L5P27909,김은혜,金恩慧,미래통합당,경기 성남시분당구갑,257,21,236,4,9,1,0,1,75,5,162,0,0,0,0,0,0,0,9,0,12,0,0,4,9,1,0,1,66,5,150,0,0
제21대,B7H6207C,박대수,朴大壽,미래한국당,비례대표,2117,74,2043,27,79,21,0,20,531,4,1435,0,0,0,0,1,0,0,28,0,45,0,0,27,79,20,0,20,503,4,1390,0,0
제21대,M0A1658U,윤호중,尹昊重,더불어민주당,경기 구리시,296,35,261,2,13,1,0,0,49,1,230,0,0,0,0,0,0,0,3,1,31,0,0,2,13,1,0,0,46,0,199,0,0
제21대,HKJ99607,이병훈,李炳勳,더불어민주당,광주 동구남구을,1705,139,1566,21,89,17,0,23,407,12,1136,0,0,6,11,3,0,1,31,2,85,0,0,15,78,14,0,22,376,10,1051,0,0
제21대,H5476989,한병도,韓秉道,더불어민주당,전북 익산시을,1580,118,1462,15,61,12,0,20,464,5,1003,0,0,0,8,2,0,0,45,0,63,0,0,15,53,10,0,20,419,5,940,0,0
제21대,JVB6983V,노용호,魯容昊,국민의힘,비례대표,388,44,344,4,26,6,0,7,84,0,261,0,0,1,5,0,0,0,14,0,24,0,0,3,21,6,0,7,70,0,237,0,0
제21대,BT62420K,박찬대,朴贊大,더불어민주당,인천 연수구갑,772,48,724,16,40,2,0,5,180,7,522,0,0,2,5,0,0,0,11,0,30,0,0,14,35,2,0,5,169,7,492,0,0
제21대,HSS7466Y,백혜련,白惠蓮,더불어민주당,경기 수원시을,660,136,524,18,47,3,0,4,175,2,411,0,0,6,8,0,0,0,36,0,86,0,0,12,39,3,0,4,139,2,325,0,0
제21대,4A067125,이광재,李光宰,더불어민주당,강원 원주시갑,508,27,481,10,31,5,0,2,163,8,289,0,0,0,3,0,0,0,6,1,17,0,0,10,28,5,0,2,157,7,272,0,0
제21대,LPB30152,최인호,崔仁昊,더불어민주당,부산 사하구갑,1107,64,1043,12,64,8,0,22,285,5,711,0,0,0,11,1,0,0,33,0,19,0,0,12,53,7,0,22,252,5,692,0,0
제21대,JQA21112,한기호,韓起鎬,미래통합당,강원 춘천시철원군화천군양구군을,409,59,350,1,17,3,0,2,105,0,281,0,0,1,3,0,0,0,11,0,44,0,0,0,14,3,0,2,94,0,237,0,0
제21대,IOW1101J,김영식,金英植,미래통합당,경북 구미시을,1360,79,1281,21,50,9,0,23,349,6,902,0,0,1,4,0,0,0,14,0,60,0,0,20,46,9,0,23,335,6,842,0,0
제21대,TZ228122,민병덕,閔炳德,더불어민주당,경기 안양시동안구갑,1728,56,1672,24,47,11,0,11,327,5,1303,0,0,0,2,0,0,0,6,1,47,0,0,24,45,11,0,11,321,4,1256,0,0
제21대,DV77269P,양경규,梁暻圭,정의당,비례대표,22,6,16,0,0,0,0,0,0,0,22,0,0,0,0,0,0,0,0,0,6,0,0,0,0,0,0,0,0,0,16,0,0
제21대,NUB4941Z,김한규,金翰奎,더불어민주당,제주 제주시을,386,42,344,0,7,2,0,1,66,0,310,0,0,0,1,0,0,0,5,0,36,0,0,0,6,2,0,1,61,0,274,0,0
제21대,52P3934K,김희곤,金熙坤,미래통합당,부산 동래구,1206,69,1137,5,43,6,0,3,305,3,841,0,0,1,2,0,0,1,22,0,43,0,0,4,41,6,0,2,283,3,798,0,0
제21대,FJK3396E,맹성규,孟聖奎,더불어민주당,인천 남동구갑,809,53,756,19,54,4,0,12,232,1,487,0,0,3,5,0,0,0,13,0,32,0,0,16,49,4,0,12,219,1,455,0,0
제21대,AFH96856,신영대,申榮大,더불어민주당,전북 군산시,731,93,638,20,47,3,0,6,169,3,483,0,0,0,3,0,0,0,17,1,72,0,0,20,44,3,0,6,152,2,411,0,0
제21대,GX38539O,유동수,柳東秀,더불어민주당,인천 계양구갑,748,63,685,14,47,5,0,5,199,9,469,0,0,0,6,0,0,0,14,1,42,0,0,14,41,5,0,5,185,8,427,0,0
제21대,MHK9919B,곽상도,郭尙道,미래통합당,대구 중구남구,268,21,247,3,8,4,0,3,73,2,175,0,0,0,0,0,0,0,4,0,17,0,0,3,8,4,0,3,69,2,158,0,0
제21대,3TO11703,권인숙,權仁淑,더불어시민당,비례대표,960,108,852,14,31,4,0,0,213,3,695,0,0,1,0,0,0,0,24,0,83,0,0,13,31,4,0,0,189,3,612,0,0
제21대,D6U6678O,김주영,金周暎,더불어민주당,경기 김포시갑,1367,112,1255,31,44,9,0,36,319,2,926,0,0,0,2,3,0,12,33,0,62,0,0,31,42,6,0,24,286,2,864,0,0
제21대,LT72093S,정일영,鄭日永,더불어민주당,인천 연수구을,1317,82,1235,16,59,10,0,34,303,1,894,0,0,0,1,0,0,3,22,0,56,0,0,16,58,10,0,31,281,1,838,0,0
제21대,FDC3144T,이종성,李鍾成,미래한국당,비례대표,1688,211,1477,26,62,14,0,19,423,5,1139,0,0,2,10,1,0,0,59,1,138,0,0,24,52,13,0,19,364,4,1001,0,0
제21대,KFM1081G,장동혁,張東赫,국민의힘,충남 보령시서천군,355,29,326,10,16,1,0,2,72,0,254,0,0,0,0,0,0,1,4,0,24,0,0,10,16,1,0,1,68,0,230,0,0
제21대,NQR1206Q,정진석,鄭鎭碩,미래통합당,충남 공주시부여군청양군,647,30,617,7,21,7,0,5,164,11,432,0,0,0,0,1,0,0,5,1,23,0,0,7,21,6,0,5,159,10,409,0,0
제21대,MD083627,정춘숙,鄭春淑,더불어민주당,경기 용인시병,1266,152,1114,16,60,7,0,4,320,15,844,0,0,3,8,1,0,0,43,0,97,0,0,13,52,6,0,4,277,15,747,0,0
제21대,VCP96419,허종식,許琮植,더불어민주당,인천 동구미추홀구갑,1355,61,1294,21,73,10,0,9,323,3,916,0,0,1,3,0,0,0,19,0,38,0,0,20,70,10,0,9,304,3,878,0,0
제21대,3249208I,송옥주,宋玉珠,더불어민주당,경기 화성시갑,1418,158,1260,18,81,9,0,5,345,14,946,0,0,0,10,0,0,0,41,7,100,0,0,18,71,9,0,5,304,7,846,0,0
제21대,M7O7878U,신정훈,辛正勳,더불어민주당,전남 나주시화순군,2379,84,2295,28,114,24,0,35,599,13,1566,0,0,0,2,0,0,0,14,1,67,0,0,28,112,24,0,35,585,12,1499,0,0
제21대,MY318392,오영환,吳永煥,더불어민주당,경기 의정부시갑,3007,66,2941,68,117,29,0,14,723,8,2048,0,0,0,6,2,0,0,21,0,37,0,0,68,111,27,0,14,702,8,2011,0,0
제21대,XEF29171,안호영,安浩永,더불어민주당,전북 완주군진안군무주군장수군,1088,83,1005,5,53,7,0,4,269,13,737,0,0,2,4,1,0,2,37,0,37,0,0,3,49,6,0,2,232,13,700,0,0
제21대,IUL4848V,윤희숙,尹喜淑,미래통합당,서울 서초구갑,123,8,115,0,2,0,0,1,34,0,86,0,0,0,0,0,0,0,3,0,5,0,0,0,2,0,0,1,31,0,81,0,0
제21대,I7R13867,이개호,李介昊,더불어민주당,전남 담양군함평군영광군장성군,1032,73,959,10,68,7,0,12,241,2,692,0,0,2,5,1,0,0,20,0,45,0,0,8,63,6,0,12,221,2,647,0,0
제21대,G7512472,이용우,李龍雨,더불어민주당,경기 고양시정,992,138,854,45,45,3,0,4,267,1,627,0,0,19,5,0,0,0,26,0,88,0,0,26,40,3,0,4,241,1,539,0,0
제21대,T465023H,주철현,朱哲鉉,더불어민주당,전남 여수시갑,1330,47,1283,42,69,14,0,7,313,5,880,0,0,1,3,1,0,1,18,0,23,0,0,41,66,13,0,6,295,5,857,0,0
제21대,1WE5693J,김태년,金太年,더불어민주당,경기 성남시수정구,361,28,333,3,12,0,0,3,70,0,273,0,0,0,0,0,0,1,4,0,23,0,0,3,12,0,0,2,66,0,250,0,0
제21대,M6H1705E,김회재,金會在,더불어민주당,전남 여수시을,842,96,746,19,64,4,0,5,231,5,514,0,0,1,1,0,0,1,21,0,72,0,0,18,63,4,0,4,210,5,442,0,0
제21대,RD42006Y,송갑석,宋甲錫,더불어민주당,광주 서구갑,1772,99,1673,29,85,20,0,14,397,8,1219,0,0,3,10,1,0,0,28,1,56,0,0,26,75,19,0,14,369,7,1163,0,0
제21대,LM13674V,송재호,宋在祜,더불어민주당,제주 제주시갑,1328,122,1206,13,63,11,0,14,334,8,885,0,0,1,4,1,0,0,19,2,95,0,0,12,59,10,0,14,315,6,790,0,0
제21대,XBT9550Q,우원식,禹元植,더불어민주당,서울 노원구을,776,70,706,11,31,6,0,3,186,1,538,0,0,1,1,0,0,0,9,0,59,0,0,10,30,6,0,3,177,1,479,0,0
제21대,9VR65006,윤영석,尹永碩,미래통합당,경남 양산시갑,626,56,570,13,26,10,0,9,148,4,416,0,0,1,1,1,0,3,19,0,31,0,0,12,25,9,0,6,129,4,385,0,0
제21대,GKD32201,이용빈,李龍彬,더불어민주당,광주 광산구갑,2591,88,2503,54,104,34,0,8,620,12,1759,0,0,2,2,2,0,0,14,1,67,0,0,52,102,32,0,8,606,11,1692,0,0
제21대,E6U4345C,임종성,林鍾聲,더불어민주당,경기 광주시을,1512,71,1441,15,73,19,0,11,370,15,1009,0,0,0,9,0,0,0,14,0,48,0,0,15,64,19,0,11,356,15,961,0,0
제21대,WMG57662,강은미,姜恩美,정의당,비례대표,685,91,594,2,12,4,0,0,122,1,544,0,0,0,1,1,0,0,20,0,69,0,0,2,11,3,0,0,102,1,475,0,0
제21대,ATB59635,김승원,金勝源,더불어민주당,경기 수원시갑,1957,92,1865,20,115,23,0,4,442,7,1346,0,0,0,2,0,0,0,18,0,72,0,0,20,113,23,0,4,424,7,1274,0,0
제21대,X3170462,박성민,朴成敏,미래통합당,울산 중구,1334,81,1253,19,57,6,0,10,277,5,960,0,0,0,4,0,0,0,12,0,65,0,0,19,53,6,0,10,265,5,895,0,0
제21대,J9S37905,황보승희,皇甫承希,미래통합당,부산 중구영도구,1002,70,932,13,49,6,0,10,243,13,668,0,0,1,1,0,0,0,13,1,54,0,0,12,48,6,0,10,230,12,614,0,0
제21대,KFS1358P,윤영덕,尹永德,더불어민주당,광주 동구남구갑,1324,70,1254,6,56,11,0,1,278,4,968,0,0,1,0,2,0,0,15,0,52,0,0,5,56,9,0,1,263,4,916,0,0
제21대,E9R4507P,권명호,權明浩,미래통합당,울산 동구,1748,111,1637,28,68,17,0,24,415,16,1180,0,0,7,6,1,0,0,33,0,64,0,0,21,62,16,0,24,382,16,1116,0,0
제21대,JZY9937U,김윤덕,金潤德,더불어민주당,전북 전주시갑,1243,78,1165,16,71,14,0,10,305,8,819,0,0,0,8,0,0,0,22,1,47,0,0,16,63,14,0,10,283,7,772,0,0
제21대,PO64874I,김홍걸,金弘傑,더불어시민당,비례대표,1739,96,1643,31,65,8,0,14,382,6,1233,0,0,3,2,0,0,0,18,0,73,0,0,28,63,8,0,14,364,6,1160,0,0
제21대,DAN6731C,박성중,朴成重,미래통합당,서울 서초구을,640,64,576,9,24,6,0,3,170,8,420,0,0,1,3,0,0,1,23,0,36,0,0,8,21,6,0,2,147,8,384,0,0
제21대,VG24001G,양금희,梁琴喜,미래통합당,대구 북구갑,1254,77,1177,14,55,13,0,31,363,7,771,0,0,1,4,0,0,1,30,2,39,0,0,13,51,13,0,30,333,5,732,0,0
제21대,CFE3998F,이상직,李相稷,더불어민주당,전북 전주시을,293,5,288,8,22,5,0,1,121,0,136,0,0,0,0,0,0,0,3,0,2,0,0,8,22,5,0,1,118,0,134,0,0
제21대,RPN2293B,장경태,張耿態,더불어민주당,서울 동대문구을,1485,95,1390,25,66,14,0,6,329,4,1041,0,0,5,4,2,0,0,23,1,60,0,0,20,62,12,0,6,306,3,981,0,0
제21대,71J2365L,전주혜,全珠惠,미래한국당,비례대표,601,73,528,3,16,9,0,5,130,2,436,0,0,1,2,1,0,0,12,0,57,0,0,2,14,8,0,5,118,2,379,0,0
제21대,5KV96424,강준현,康準鉉,더불어민주당,세종특별자치시을,960,62,898,30,60,4,0,3,247,2,614,0,0,1,8,1,0,0,15,0,37,0,0,29,52,3,0,3,232,2,577,0,0
제21대,7BM2933Y,김영호,金映豪,더불어민주당,서울 서대문구을,794,64,730,15,40,7,0,1,188,5,538,0,0,1,2,0,0,0,13,2,46,0,0,14,38,7,0,1,175,3,492,0,0
제21대,6AR6743G,김희국,金熙國,미래통합당,경북 군위군의성군청송군영덕군,522,34,488,6,30,11,0,6,155,5,309,0,0,0,5,0,0,0,12,1,16,0,0,6,25,11,0,6,143,4,293,0,0
제21대,QUM8288K,이달곤,李達坤,미래통합당,경남 창원시진해구,420,45,375,2,20,9,0,7,87,2,293,0,0,1,2,0,0,2,11,1,28,0,0,1,18,9,0,5,76,1,265,0,0
제21대,1X376850,이영,李永,미래한국당,비례대표,425,39,386,3,8,5,0,5,128,4,272,0,0,0,0,0,0,0,21,0,18,0,0,3,8,5,0,5,107,4,254,0,0
제21대,4019850M,박정,朴釘,더불어민주당,경기 파주시을,1437,83,1354,27,94,18,0,14,363,10,911,0,0,4,5,1,0,0,17,1,55,0,0,23,89,17,0,14,346,9,856,0,0
제21대,MO52543L,변재일,卞在一,더불어민주당,충북 청주시청원구,519,47,472,18,27,2,0,8,135,1,328,0,0,0,2,1,0,0,11,0,33,0,0,18,25,1,0,8,124,1,295,0,0
제21대,XWX1513T,윤영찬,尹永燦,더불어민주당,경기 성남시중원구,535,39,496,8,35,5,0,4,118,2,363,0,0,0,0,2,0,0,11,0,26,0,0,8,35,3,0,4,107,2,337,0,0
제21대,FOK3459D,서삼석,徐參錫,더불어민주당,전남 영암군무안군신안군,1047,112,935,14,84,6,0,7,276,11,649,0,0,2,15,0,0,0,26,0,69,0,0,12,69,6,0,7,250,11,580,0,0
제21대,V0O5343U,우상호,禹相虎,더불어민주당,서울 서대문구갑,140,32,108,2,8,0,0,0,29,0,101,0,0,1,0,0,0,0,4,0,27,0,0,1,8,0,0,0,25,0,74,0,0
제21대,A0P4646G,최형두,崔炯斗,미래통합당,경남 창원시마산합포구,956,80,876,27,40,7,0,11,236,4,631,0,0,7,2,2,0,0,16,0,53,0,0,20,38,5,0,11,220,4,578,0,0
제21대,FYI20317,조승래,趙承來,더불어민주당,대전 유성구갑,1006,89,917,31,73,7,0,9,258,2,626,0,0,13,8,0,0,0,27,0,41,0,0,18,65,7,0,9,231,2,585,0,0
제21대,M7T9712V,최승재,崔承宰,미래한국당,비례대표,815,65,750,11,35,15,0,9,193,6,546,0,0,0,0,1,0,0,10,0,54,0,0,11,35,14,0,9,183,6,492,0,0
제21대,C7E79345,권칠승,權七勝,더불어민주당,경기 화성시병,839,96,743,8,51,11,0,2,223,4,540,0,0,1,4,2,0,0,22,0,67,0,0,7,47,9,0,2,201,4,473,0,0
제21대,7JC3239L,윤두현,尹斗鉉,미래통합당,경북 경산시,797,52,745,7,30,6,0,11,208,6,529,0,0,0,0,0,0,0,12,0,40,0,0,7,30,6,0,11,196,6,489,0,0
제21대,0767470D,이낙연,李洛淵,더불어민주당,서울 종로구,89,10,79,2,11,1,0,0,31,0,44,0,0,0,1,0,0,0,0,0,9,0,0,2,10,1,0,0,31,0,35,0,0
제21대,3425169D,정필모,鄭必模,더불어시민당,비례대표,796,77,719,19,43,7,0,2,169,5,551,0,0,11,10,0,0,0,20,0,36,0,0,8,33,7,0,2,149,5,515,0,0
제21대,2N793392,홍성국,洪性國,더불어민주당,세종특별자치시갑,1935,84,1851,50,107,19,0,17,474,5,1263,0,0,0,4,1,0,2,26,0,51,0,0,50,103,18,0,15,448,5,1212,0,0
제21대,3BC6890E,김미애,金美愛,미래통합당,부산 해운대구을,585,93,492,5,20,4,0,8,147,6,395,0,0,2,1,1,0,0,30,2,57,0,0,3,19,3,0,8,117,4,338,0,0
제21대,HXT76735,박상혁,朴商赫,더불어민주당,경기 김포시을,1975,131,1844,27,106,14,0,19,452,7,1350,0,0,1,5,1,0,0,37,1,86,0,0,26,101,13,0,19,415,6,1264,0,0
제21대,CNW5754J,송석준,宋錫俊,미래통합당,경기 이천시,643,61,582,2,34,10,0,5,163,5,424,0,0,0,4,1,0,0,22,1,33,0,0,2,30,9,0,5,141,4,391,0,0
제21대,RQQ3807K,위성곤,魏聖坤,더불어민주당,제주 서귀포시,1634,125,1509,15,69,17,0,18,365,8,1142,0,0,2,6,1,0,0,42,0,74,0,0,13,63,16,0,18,323,8,1068,0,0
제21대,AE685067,이규민,李圭閔,더불어민주당,경기 안성시,1240,39,1201,24,76,15,0,3,330,1,791,0,0,0,2,0,0,0,7,0,30,0,0,24,74,15,0,3,323,1,761,0,0
제21대,TP066860,정정순,鄭正淳,더불어민주당,충북 청주시상당구,153,14,139,1,7,0,0,0,49,1,95,0,0,0,0,0,0,0,3,0,11,0,0,1,7,0,0,0,46,1,84,0,0
제21대,BCQ55105,한준호,韓俊鎬,더불어민주당,경기 고양시을,1508,101,1407,46,74,11,0,4,326,1,1046,0,0,3,5,0,0,0,11,0,82,0,0,43,69,11,0,4,315,1,964,0,0
제21대,XA42275R,홍정민,洪貞敏,더불어민주당,경기 고양시병,1329,84,1245,36,68,9,0,3,330,1,882,0,0,0,4,0,0,0,26,0,54,0,0,36,64,9,0,3,304,1,828,0,0
제21대,GX22581L,강민국,姜旻局,미래통합당,경남 진주시을,456,49,407,4,17,7,0,0,132,6,290,0,0,0,0,0,0,0,19,0,30,0,0,4,17,7,0,0,113,6,260,0,0
제21대,1BX7234U,김경만,金京萬,더불어시민당,비례대표,1508,99,1409,26,76,20,0,15,397,5,969,0,0,3,4,1,0,2,36,0,53,0,0,23,72,19,0,13,361,5,916,0,0
제21대,JNL7001A,김선교,金善敎,미래통합당,경기 여주시양평군,1073,114,959,16,43,22,0,10,279,4,699,0,0,3,3,1,0,2,25,1,79,0,0,13,40,21,0,8,254,3,620,0,0
제21대,2NV6751W,장철민,張喆敏,더불어민주당,대전 동구,1266,77,1189,42,78,16,0,8,312,2,808,0,0,2,0,0,0,1,24,1,49,0,0,40,78,16,0,7,288,1,759,0,0
제21대,S824682L,박홍근,朴洪根,더불어민주당,서울 중랑구을,1359,87,1272,18,51,12,0,10,388,3,877,0,0,1,3,1,0,2,35,1,44,0,0,17,48,11,0,8,353,2,833,0,0
제21대,SRP7336N,신원식,申源湜,미래한국당,비례대표,525,26,499,8,22,8,0,4,122,5,356,0,0,0,1,0,0,0,4,0,21,0,0,8,21,8,0,4,118,5,335,0,0
제21대,SZ51175J,이자스민,李자스민,정의당,비례대표,20,5,15,0,0,0,0,0,0,0,20,0,0,0,0,0,0,0,0,0,5,0,0,0,0,0,0,0,0,0,15,0,0
제21대,6EN68926,송언석,宋彦錫,미래통합당,경북 김천시,821,88,733,11,34,9,0,17,235,14,501,0,0,0,1,0,0,7,18,5,57,0,0,11,33,9,0,10,217,9,444,0,0
제21대,IUD9392R,이재명,李在明,더불어민주당,인천 계양구을,26,6,20,1,3,0,0,0,3,0,19,0,0,0,1,0,0,0,0,0,5,0,0,1,2,0,0,0,3,0,14,0,0
제21대,4XG1439M,고영인,高永寅,더불어민주당,경기 안산시단원구갑,1189,88,1101,39,55,11,0,2,336,2,744,0,0,3,5,2,0,0,19,0,59,0,0,36,50,9,0,2,317,2,685,0,0
제21대,LQW3652K,김웅,金雄,미래통합당,서울 송파구갑,248,11,237,3,9,1,0,0,67,5,163,0,0,0,0,0,0,0,0,0,11,0,0,3,9,1,0,0,67,5,152,0,0
제21대,L7J93733,서범수,徐範洙,미래통합당,울산 울주군,706,66,640,7,22,10,0,4,184,1,478,0,0,0,1,0,0,0,16,1,48,0,0,7,21,10,0,4,168,0,430,0,0
제21대,ZA54991S,안민석,安敏錫,더불어민주당,경기 오산시,916,73,843,12,47,5,0,0,232,3,617,0,0,2,0,1,0,0,16,0,54,0,0,10,47,4,0,0,216,3,563,0,0
제21대,CCU1009B,이해식,李海植,더불어민주당,서울 강동구을,976,116,860,16,50,7,0,5,303,2,593,0,0,0,0,0,0,0,29,0,87,0,0,16,50,7,0,5,274,2,506,0,0
제21대,PFG2137X,정희용,鄭熙溶,미래통합당,경북 고령군성주군칠곡군,1098,104,994,8,58,13,0,14,301,9,695,0,0,0,5,1,0,2,24,1,71,0,0,8,53,12,0,12,277,8,624,0,0
제21대,7XY7109I,성일종,成一鍾,미래통합당,충남 서산시태안군,1401,87,1314,20,51,13,0,15,333,7,962,0,0,2,0,3,0,1,20,0,61,0,0,18,51,10,0,14,313,7,901,0,0
제21대,GP07421U,윤건영,尹建永,더불어민주당,서울 구로구을,640,30,610,9,27,2,0,8,122,3,469,0,0,0,1,0,0,0,4,0,25,0,0,9,26,2,0,8,118,3,444,0,0
제21대,JC14718Q,윤준병,尹準炳,더불어민주당,전북 정읍시고창군,2206,281,1925,17,105,25,0,22,522,7,1508,0,0,0,8,13,0,6,69,0,185,0,0,17,97,12,0,16,453,7,1323,0,0
제21대,5UN9725L,이용,李鏞,미래한국당,비례대표,968,66,902,9,31,18,0,8,235,1,666,0,0,5,3,4,0,0,15,0,39,0,0,4,28,14,0,8,220,1,627,0,0
제21대,QTW6852F,이태규,李泰珪,국민의당,비례대표,546,72,474,4,33,3,0,10,135,6,355,0,0,1,5,1,0,0,20,0,45,0,0,3,28,2,0,10,115,6,310,0,0
제21대,ZKU88693,김경협,金炅俠,더불어민주당,경기 부천시갑,721,72,649,14,34,6,0,7,217,5,438,0,0,5,2,0,0,1,16,1,47,0,0,9,32,6,0,6,201,4,391,0,0
제21대,2UD1340H,김성주,金成柱,더불어민주당,전북 전주시병,978,72,906,17,54,6,0,8,280,6,607,0,0,1,10,0,0,0,25,1,35,0,0,16,44,6,0,8,255,5,572,0,0
제21대,CT85313K,서병수,徐秉洙,미래통합당,부산 진구갑,941,65,876,11,34,5,0,7,228,6,650,0,0,0,1,0,0,0,10,0,54,0,0,11,33,5,0,7,218,6,596,0,0
제21대,I5I2468R,최기상,崔基相,더불어민주당,서울 금천구,725,74,651,15,50,7,0,7,140,2,504,0,0,1,5,0,0,0,12,0,56,0,0,14,45,7,0,7,128,2,448,0,0
제21대,UB114374,한무경,韓茂景,미래한국당,비례대표,1167,60,1107,17,44,9,0,9,306,9,773,0,0,4,2,0,0,1,16,1,36,0,0,13,42,9,0,8,290,8,737,0,0
제21대,CNZ51556,김예지,金睿智,미래한국당,비례대표,1617,170,1447,19,58,21,0,32,390,7,1090,0,0,2,9,5,0,0,31,0,123,0,0,17,49,16,0,32,359,7,967,0,0
제21대,6YT83269,이명수,李明洙,미래통합당,충남 아산시갑,1510,104,1406,17,54,29,0,27,385,6,992,0,0,1,5,0,0,0,22,0,76,0,0,16,49,29,0,27,363,6,916,0,0
제21대,W1Q6753M,이은주,李恩周,정의당,비례대표,679,71,608,4,11,6,0,0,150,2,506,0,0,0,1,0,0,0,17,0,53,0,0,4,10,6,0,0,133,2,453,0,0
제21대,TJW93720,전용기,田溶冀,더불어시민당,비례대표,1436,121,1315,20,88,24,0,16,342,6,940,0,0,0,3,2,0,5,29,0,82,0,0,20,85,22,0,11,313,6,858,0,0
제21대,Y7K5946R,지성호,池成浩,미래한국당,비례대표,1389,53,1336,17,68,13,0,7,353,8,923,0,0,0,4,1,0,0,10,0,38,0,0,17,64,12,0,7,343,8,885,0,0
제21대,14M56632,강기윤,姜起潤,미래통합당,경남 창원시성산구,1259,184,1075,26,51,14,0,15,296,9,848,0,0,5,10,4,0,0,37,2,126,0,0,21,41,10,0,15,259,7,722,0,0
제21대,WCD5518S,고민정,高旼廷,더불어민주당,서울 광진구을,384,44,340,1,17,5,0,5,92,0,264,0,0,1,3,1,0,0,13,0,26,0,0,0,14,4,0,5,79,0,238,0,0
제21대,B7D7534L,김영배,金永培,더불어민주당,서울 성북구갑,1429,88,1341,15,64,10,0,11,331,6,992,0,0,0,3,0,0,0,24,0,61,0,0,15,61,10,0,11,307,6,931,0,0
제21대,QD25323M,최혜영,崔惠英,더불어시민당,비례대표,1722,181,1541,42,81,13,0,7,410,4,1165,0,0,3,4,0,0,0,35,0,139,0,0,39,77,13,0,7,375,4,1026,0,0
제21대,ZYP7962W,김석기,金碩基,미래통합당,경북 경주시,1204,60,1144,13,44,18,0,9,293,9,818,0,0,1,1,2,0,0,7,1,48,0,0,12,43,16,0,9,286,8,770,0,0
제21대,OFE45081,김용민,金容民,더불어민주당,경기 남양주시병,949,112,837,13,35,8,0,0,186,4,703,0,0,2,0,0,0,0,17,1,92,0,0,11,35,8,0,0,169,3,611,0,0
제21대,MSY7784L,윤상현,尹相現,국민의힘,인천 동구미추홀구을,390,56,334,1,8,6,0,6,91,2,276,0,0,0,0,2,0,0,5,0,49,0,0,1,8,4,0,6,86,2,227,0,0
제21대,DPZ7685X,전봉민,田奉珉,미래통합당,부산 수영구,898,100,798,10,41,2,0,1,203,8,633,0,0,2,2,0,0,0,17,1,78,0,0,8,39,2,0,1,186,7,555,0,0
제21대,LBC8144B,김영선,金映宣,국민의힘,,299,34,265,4,11,2,0,5,58,0,219,0,0,0,1,0,0,0,6,0,27,0,0,4,10,2,0,5,52,0,192,0,0
제21대,K3W33496,박광온,朴洸瑥,더불어민주당,경기 수원시정,643,100,543,10,35,10,0,6,152,3,427,0,0,0,0,1,0,1,14,2,82,0,0,10,35,9,0,5,138,1,345,0,0
제21대,8FB1535Y,어기구,魚基龜,더불어민주당,충남 당진시,804,81,723,7,48,8,0,8,184,1,548,0,0,1,8,1,0,0,20,0,51,0,0,6,40,7,0,8,164,1,497,0,0
제21대,FH777496,임호선,林昊宣,더불어민주당,충북 증평군진천군음성군,2277,106,2171,39,118,10,0,8,539,15,1548,0,0,3,6,0,0,0,17,0,80,0,0,36,112,10,0,8,522,15,1468,0,0
제21대,G152611B,추경호,秋慶鎬,미래통합당,대구 달성군,1390,101,1289,19,54,18,0,19,397,13,870,0,0,0,0,2,0,6,50,0,43,0,0,19,54,16,0,13,347,13,827,0,0
제21대,3RW63706,이주환,李周桓,미래통합당,부산 연제구,1422,148,1274,22,61,14,0,14,376,10,925,0,0,4,12,2,0,0,36,2,92,0,0,18,49,12,0,14,340,8,833,0,0
제21대,V429892C,정성호,鄭成湖,더불어민주당,경기 양주시,1082,63,1019,14,30,5,0,15,214,7,797,0,0,0,2,0,0,3,11,0,47,0,0,14,28,5,0,12,203,7,750,0,0
제21대,GD131760,홍문표,洪文杓,미래통합당,충남 홍성군예산군,954,40,914,14,39,9,0,10,247,5,630,0,0,0,1,0,0,0,12,1,26,0,0,14,38,9,0,10,235,4,604,0,0
제21대,S741317G,조명희,曺明姬,미래한국당,비례대표,1336,104,1232,16,58,18,0,32,315,4,893,0,0,3,4,1,0,1,23,1,71,0,0,13,54,17,0,31,292,3,822,0,0
제21대,GDG1847Z,권성동,權性東,무소속,강원 강릉시,796,40,756,16,40,6,0,14,227,3,490,0,0,0,2,0,0,1,14,0,23,0,0,16,38,6,0,13,213,3,467,0,0
제21대,4X525582,배현진,裵賢鎭,미래통합당,서울 송파구을,368,40,328,10,20,7,0,7,101,5,218,0,0,3,8,0,0,2,16,0,11,0,0,7,12,7,0,5,85,5,207,0,0
제21대,DAV7257X,이원택,李源澤,더불어민주당,전북 김제시부안군,978,91,887,37,61,3,0,6,244,4,623,0,0,1,5,0,0,3,27,0,55,0,0,36,56,3,0,3,217,4,568,0,0
제21대,TST4507I,안규백,安圭伯,더불어민주당,서울 동대문구갑,996,68,928,18,54,12,0,21,280,2,609,0,0,1,4,0,0,1,18,0,44,0,0,17,50,12,0,20,262,2,565,0,0
제21대,JMY9959W,윤관석,尹官石,더불어민주당,인천 남동구을,706,34,672,11,44,7,0,5,219,2,418,0,0,1,0,0,0,0,10,0,23,0,0,10,44,7,0,5,209,2,395,0,0
제21대,4T026790,임오경,林五卿,더불어민주당,경기 광명시갑,1077,127,950,37,52,18,0,12,296,5,657,0,0,7,13,10,0,2,31,1,63,0,0,30,39,8,0,10,265,4,594,0,0
제21대,UHB5553T,정태호,鄭泰浩,더불어민주당,서울 관악구을,875,75,800,10,33,6,0,9,173,0,644,0,0,1,5,0,0,5,25,0,39,0,0,9,28,6,0,4,148,0,605,0,0
제21대,Z6R3959C,조해진,曺海珍,미래통합당,경남 밀양시의령군함안군창녕군,225,41,184,1,11,2,0,2,63,2,144,0,0,0,0,0,0,0,15,0,26,0,0,1,11,2,0,2,48,2,118,0,0
제21대,TRE2429O,강훈식,姜勳植,더불어민주당,충남 아산시을,751,71,680,14,33,4,0,4,172,10,514,0,0,1,5,0,0,0,19,1,45,0,0,13,28,4,0,4,153,9,469,0,0
제21대,J2O8643H,도종환,都鍾煥,더불어민주당,충북 청주시흥덕구,742,72,670,19,54,7,0,0,193,2,467,0,0,3,10,1,0,0,20,0,38,0,0,16,44,6,0,0,173,2,429,0,0
제21대,17M85910,소병철,蘇秉哲,더불어민주당,전남 순천시광양시곡성군구례군갑,555,99,456,17,45,1,0,1,124,0,367,0,0,1,5,0,0,0,15,0,78,0,0,16,40,1,0,1,109,0,289,0,0
제21대,JEZ3130Q,김형동,金亨東,미래통합당,경북 안동시예천군,1174,69,1105,15,39,10,0,3,292,11,804,0,0,0,2,0,0,0,24,1,42,0,0,15,37,10,0,3,268,10,762,0,0
제21대,3ZR4438W,이인영,李仁榮,더불어민주당,서울 구로구갑,295,44,251,5,18,2,0,2,69,1,198,0,0,1,0,0,0,2,6,0,35,0,0,4,18,2,0,0,63,1,163,0,0
제21대,O0I2045I,이정문,李楨文,더불어민주당,충남 천안시병,1365,119,1246,14,58,12,0,6,362,8,905,0,0,1,4,0,0,0,34,0,80,0,0,13,54,12,0,6,328,8,825,0,0
제21대,EMC8812P,홍석준,洪碩晙,미래통합당,대구 달서구갑,545,103,442,5,32,7,0,8,154,3,336,0,0,2,5,0,0,2,26,1,67,0,0,3,27,7,0,6,128,2,269,0,0
제21대,1MU99298,김철민,金哲玟,더불어민주당,경기 안산시상록구을,1694,82,1612,20,73,19,0,7,424,7,1144,0,0,1,3,0,0,0,34,1,43,0,0,19,70,19,0,7,390,6,1101,0,0
제21대,PAO22428,송영길,宋永吉,더불어민주당,인천 계양구을,530,16,514,27,33,7,0,2,148,2,311,0,0,0,0,0,0,0,3,0,13,0,0,27,33,7,0,2,145,2,298,0,0
제21대,WJL30106,조정훈,趙廷訓,시대전환,비례대표,358,39,319,2,14,2,0,3,55,0,282,0,0,0,2,2,0,0,0,0,35,0,0,2,12,0,0,3,55,0,247,0,0
제21대,SE233396,윤재갑,尹才鉀,더불어민주당,전남 해남군완도군진도군,1628,112,1516,22,79,16,0,19,436,11,1045,0,0,1,4,1,0,2,27,0,77,0,0,21,75,15,0,17,409,11,968,0,0
제21대,6RM29022,최재형,崔在亨,국민의힘,서울 종로구,132,19,113,0,7,0,0,2,27,0,96,0,0,0,2,0,0,0,5,0,12,0,0,0,5,0,0,2,22,0,84,0,0
제21대,4L695580,김원이,金元二,더불어민주당,전남 목포시,984,100,884,9,51,4,0,3,238,3,676,0,0,1,6,1,0,0,32,1,59,0,0,8,45,3,0,3,206,2,617,0,0
제21대,8KF7223D,이성만,李成萬,더불어민주당,인천 부평구갑,1658,93,1565,37,82,5,0,17,404,5,1108,0,0,2,1,0,0,0,15,0,75,0,0,35,81,5,0,17,389,5,1033,0,0
제21대,DAY6557K,정동만,鄭東萬,미래통합당,부산 기장군,846,61,785,12,38,7,0,6,212,6,565,0,0,0,4,0,0,0,16,0,41,0,0,12,34,7,0,6,196,6,524,0,0
제21대,O6D8329R,민홍철,閔洪喆,더불어민주당,경남 김해시갑,664,125,539,7,43,2,0,4,191,4,413,0,0,2,6,0,0,0,28,2,87,0,0,5,37,2,0,4,163,2,326,0,0
제21대,25I8709Q,조오섭,曺五燮,더불어민주당,광주 북구갑,1976,94,1882,20,85,11,0,6,470,4,1380,0,0,0,7,0,0,0,19,1,67,0,0,20,78,11,0,6,451,3,1313,0,0
제21대,5K93695T,김승수,金承洙,미래통합당,대구 북구을,1187,103,1084,16,55,12,0,19,257,8,820,0,0,1,3,0,0,0,18,0,81,0,0,15,52,12,0,19,239,8,739,0,0
제21대,9LD2641Q,김정호,金禎鎬,더불어민주당,경남 김해시을,2748,132,2616,25,122,17,0,25,612,6,1941,0,0,0,3,1,0,4,30,4,90,0,0,25,119,16,0,21,582,2,1851,0,0
제21대,Q9H5708M,김진표,金振杓,더불어민주당,경기 수원시무,640,39,601,6,33,6,0,9,186,3,397,0,0,0,6,0,0,0,6,0,27,0,0,6,27,6,0,9,180,3,370,0,0
제21대,F0I5053J,우신구,禹信九,국민의힘,비례대표,38,4,34,0,0,0,0,0,0,0,38,0,0,0,0,0,0,0,0,0,4,0,0,0,0,0,0,0,0,0,34,0,0
제21대,0WL9321T,유정주,兪訂炷,더불어시민당,비례대표,1749,60,1689,26,76,25,0,16,432,3,1171,0,0,1,4,0,0,0,11,0,44,0,0,25,72,25,0,16,421,3,1127,0,0
제21대,NLR6572J,임병헌,林炳憲,무소속,대구 중구남구,397,27,370,6,24,1,0,11,89,0,266,0,0,0,1,0,0,0,2,0,24,0,0,6,23,1,0,11,87,0,242,0,0
제21대,IN328264,조정식,趙正湜,더불어민주당,경기 시흥시을,409,52,357,11,21,2,0,9,105,1,260,0,0,2,0,0,0,1,19,0,30,0,0,9,21,2,0,8,86,1,230,0,0
제21대,KR14136C,홍영표,洪永杓,더불어민주당,인천 부평구을,465,28,437,6,23,0,0,1,151,2,282,0,0,0,0,0,0,0,2,0,26,0,0,6,23,0,0,1,149,2,256,0,0
제21대,QHL3248U,김남국,金南局,더불어민주당,경기 안산시단원구을,1150,75,1075,41,49,12,0,3,274,2,769,0,0,3,2,3,0,0,13,0,54,0,0,38,47,9,0,3,261,2,715,0,0
제21대,NTT8182Q,김민기,金敏基,더불어민주당,경기 용인시을,742,71,671,17,49,6,0,2,182,2,484,0,0,0,4,0,0,0,23,0,44,0,0,17,45,6,0,2,159,2,440,0,0
제21대,CAA7713A,백종헌,白宗憲,미래통합당,부산 금정구,1397,53,1344,16,62,8,0,5,314,11,981,0,0,1,9,0,0,0,21,0,22,0,0,15,53,8,0,5,293,11,959,0,0
제21대,0R68099X,이수진,李壽珍,더불어시민당,비례대표,1942,148,1794,15,71,20,0,3,441,7,1385,0,0,1,4,0,0,0,37,1,105,0,0,14,67,20,0,3,404,6,1280,0,0
제21대,16D7652C,이원욱,李元旭,더불어민주당,경기 화성시을,1036,83,953,7,49,18,0,18,250,0,694,0,0,1,2,3,0,0,16,0,61,0,0,6,47,15,0,18,234,0,633,0,0
제21대,5MD4184K,홍기원,洪起元,더불어민주당,경기 평택시갑,862,57,805,7,50,6,0,2,203,3,591,0,0,1,5,0,0,0,15,0,36,0,0,6,45,6,0,2,188,3,555,0,0
제21대,FRN1867O,홍익표,洪翼杓,더불어민주당,서울 중구성동구갑,693,45,648,15,43,11,0,6,157,2,459,0,0,0,3,1,0,2,13,0,26,0,0,15,40,10,0,4,144,2,433,0,0
제21대,L7T64271,김수흥,金洙興,더불어민주당,전북 익산시갑,1141,96,1045,13,70,19,0,27,298,6,708,0,0,2,5,4,0,13,24,0,48,0,0,11,65,15,0,14,274,6,660,0,0
제21대,LNR7932L,김진애,金鎭愛,열린민주당,비례대표,155,6,149,0,6,5,0,0,36,1,107,0,0,0,0,0,0,0,2,0,4,0,0,0,6,5,0,0,34,1,103,0,0
제21대,PEP6922S,박용진,朴用鎭,더불어민주당,서울 강북구을,699,82,617,3,23,6,0,1,148,7,511,0,0,0,0,0,0,0,19,0,63,0,0,3,23,6,0,1,129,7,448,0,0
제21대,8P37634C,강득구,姜得求,더불어민주당,경기 안양시만안구,1459,108,1351,14,52,20,0,12,293,5,1063,0,0,0,1,1,0,0,24,0,82,0,0,14,51,19,0,12,269,5,981,0,0
제21대,9D939735,김성원,金成願,미래통합당,경기 동두천시연천군,1667,193,1474,34,76,21,0,10,428,8,1090,0,0,4,6,4,0,0,48,1,130,0,0,30,70,17,0,10,380,7,960,0,0
제21대,UM51067K,인재근,印在謹,더불어민주당,서울 도봉구갑,1364,80,1284,16,85,18,0,4,347,7,887,0,0,2,14,2,0,0,22,1,39,0,0,14,71,16,0,4,325,6,848,0,0
제21대,G1570880,신동근,申東根,더불어민주당,인천 서구을,914,69,845,20,53,5,0,3,236,5,592,0,0,0,5,1,0,1,15,0,47,0,0,20,48,4,0,2,221,5,545,0,0
제21대,NAL4555X,홍준표,洪準杓,무소속,대구 수성구을,290,16,274,3,5,5,0,2,110,3,162,0,0,0,0,2,0,0,2,2,10,0,0,3,5,3,0,2,108,1,152,0,0
제21대,M2Q9024I,김종민,金鍾民,더불어민주당,충남 논산시계룡시금산군,817,46,771,18,45,1,0,6,153,0,594,0,0,2,1,0,0,0,8,0,35,0,0,16,44,1,0,6,145,0,559,0,0
제21대,NCP9875N,류호정,柳好貞,정의당,비례대표,809,60,749,2,16,4,0,1,142,3,641,0,0,1,0,0,0,0,7,0,52,0,0,1,16,4,0,1,135,3,589,0,0
제21대,N4R2421C,박덕흠,朴德欽,미래통합당,충북 보은군옥천군영동군괴산군,1691,61,1630,12,69,17,0,23,398,11,1161,0,0,0,3,3,0,0,15,1,39,0,0,12,66,14,0,23,383,10,1122,0,0
제21대,NCO99988,허숙정,許淑湞,더불어민주당,비례대표,79,4,75,0,0,0,0,0,2,0,77,0,0,0,0,0,0,0,0,0,4,0,0,0,0,0,0,0,2,0,73,0,0
제21대,IL74008M,박성준,朴省俊,더불어민주당,서울 중구성동구을,1680,48,1632,26,84,22,0,19,424,11,1094,0,0,0,1,0,0,2,5,0,40,0,0,26,83,22,0,17,419,11,1054,0,0
제21대,MU69217P,유상범,劉相凡,미래통합당,강원 홍천군횡성군영월군평창군,534,31,503,15,24,9,0,3,121,2,360,0,0,1,3,0,0,0,7,0,20,0,0,14,21,9,0,3,114,2,340,0,0
제21대,WTR5885Y,이소영,李素永,더불어민주당,경기 의왕시과천시,504,51,453,6,18,6,0,2,117,1,354,0,0,3,1,0,0,0,8,0,39,0,0,3,17,6,0,2,109,1,315,0,0
제21대,0VU8517U,황희,黃熙,더불어민주당,서울 양천구갑,306,32,274,2,20,3,0,2,62,3,214,0,0,0,1,0,0,0,7,0,24,0,0,2,19,3,0,2,55,3,190,0,0
제21대,E1J8836Y,김정재,金汀才,미래통합당,경북 포항시북구,1135,106,1029,11,35,18,0,17,327,12,715,0,0,0,2,3,0,0,31,0,70,0,0,11,33,15,0,17,296,12,645,0,0
제21대,8SV6917G,주호영,朱豪英,미래통합당,대구 수성구갑,408,50,358,9,11,2,0,7,98,0,281,0,0,0,1,0,0,0,5,0,44,0,0,9,10,2,0,7,93,0,237,0,0
제21대,ICH23251,최강욱,崔康旭,열린민주당,비례대표,642,62,580,6,10,9,0,2,95,0,520,0,0,0,0,0,0,0,2,0,60,0,0,6,10,9,0,2,93,0,460,0,0
제21대,TZP9391O,이철규,李喆圭,미래통합당,강원 동해시태백시삼척시정선군,584,50,534,10,29,2,0,4,181,4,354,0,0,2,5,0,0,0,25,0,18,0,0,8,24,2,0,4,156,4,336,0,0
제21대,L2I9861C,강대식,姜大植,미래통합당,대구 동구을,1025,96,929,11,46,5,0,28,230,6,699,0,0,2,5,0,0,1,15,0,73,0,0,9,41,5,0,27,215,6,626,0,0
제21대,CI15627C,김두관,金斗官,더불어민주당,경남 양산시을,1017,66,951,3,37,11,0,11,187,0,768,0,0,0,1,3,0,2,4,0,56,0,0,3,36,8,0,9,183,0,712,0,0
제21대,W4X85128,박대출,朴大出,미래통합당,경남 진주시갑,419,92,327,2,14,4,0,13,84,1,301,0,0,0,0,1,0,3,10,0,78,0,0,2,14,3,0,10,74,1,223,0,0
제21대,SBK1544B,정찬민,鄭燦敏,미래통합당,경기 용인시갑,402,31,371,3,17,4,0,5,106,0,267,0,0,1,0,0,0,0,5,0,25,0,0,2,17,4,0,5,101,0,242,0,0
제21대,B7R2742J,기동민,奇東旻,더불어민주당,서울 성북구을,1265,78,1187,17,59,13,0,14,303,5,854,0,0,0,3,0,0,0,16,0,59,0,0,17,56,13,0,14,287,5,795,0,0
제21대,5765663F,김영진,金榮鎭,더불어민주당,경기 수원시병,608,74,534,3,35,2,0,9,117,1,441,0,0,0,5,1,0,3,15,0,50,0,0,3,30,1,0,6,102,1,391,0,0
제21대,A3H7195R,박완주,朴完柱,더불어민주당,충남 천안시을,445,58,387,6,22,5,0,1,123,2,286,0,0,1,0,0,0,0,24,0,33,0,0,5,22,5,0,1,99,2,253,0,0
제21대,7O71647Z,양이원영,梁李媛瑛,더불어시민당,비례대표,1020,59,961,11,57,15,0,1,281,2,653,0,0,1,0,0,0,0,8,0,50,0,0,10,57,15,0,1,273,2,603,0,0
제21대,EVH1507C,이헌승,李憲昇,미래통합당,부산 부산진구을,972,90,882,12,39,5,0,3,200,4,709,0,0,2,8,0,0,0,32,0,48,0,0,10,31,5,0,3,168,4,661,0,0
제21대,N9X9673B,전혜숙,全惠淑,더불어민주당,서울 광진구갑,1027,62,965,19,48,10,0,6,251,5,688,0,0,1,1,0,0,0,17,0,43,0,0,18,47,10,0,6,234,5,645,0,0
제21대,7469929V,구자근,具滋根,미래통합당,경북 구미시갑,1996,141,1855,28,82,15,0,20,464,15,1372,0,0,0,6,0,0,1,32,1,101,0,0,28,76,15,0,19,432,14,1271,0,0
제21대,VRY5522V,민형배,,더불어민주당,광주 광산구을,2588,325,2263,25,79,32,0,14,563,12,1863,0,0,1,0,5,0,0,50,1,268,0,0,24,79,27,0,14,513,11,1595,0,0
제21대,QKO6165V,박진,朴振,미래통합당,서울 강남구을,480,30,450,4,21,7,0,6,119,3,320,0,0,0,0,1,0,0,4,1,24,0,0,4,21,6,0,6,115,2,296,0,0
제21대,Z7Y7827F,최종윤,崔鍾允,더불어민주당,경기 하남시,1614,100,1514,20,106,12,0,3,362,4,1107,0,0,0,9,1,0,0,22,1,67,0,0,20,97,11,0,3,340,3,1040,0,0
제21대,F5U2979W,김학용,金學容,국민의힘,경기 안성시,533,28,505,10,35,8,0,9,125,0,346,0,0,0,1,0,0,0,9,0,18,0,0,10,34,8,0,9,116,0,328,0,0
제21대,09I2323E,김한정,金漢正,더불어민주당,경기 남양주시을,217,30,187,6,18,3,0,0,48,3,139,0,0,0,3,0,0,0,8,1,18,0,0,6,15,3,0,0,40,2,121,0,0
제21대,9V18755A,양경숙,梁敬淑,더불어시민당,비례대표,1234,110,1124,13,47,24,0,9,267,4,870,0,0,0,2,1,0,1,23,1,82,0,0,13,45,23,0,8,244,3,788,0,0
