대수,국회의원코드,국회의원명,국회의원한자명,정당명,선거구명,발의수(전체),발의수(대표발의),발의수(공동발의),원안가결(전체),수정가결(전체),철회(전체),부결(전체),수정안반영폐기(전체),대안반영폐기(전체),폐기(전체),임기만료폐기(전체),회기불계속폐기(전체),기타(전체),원안가결(대표발의),수정가결(대표발의),철회(대표발의),부결(대표발의),수정안반영폐기(대표발의),대안반영폐기(대표발의),폐기(대표발의),임기만료폐기(대표발의),회기불계속폐기(대표발의),기타,원안가결(공동발의),수정가결(공동발의),철회(공동발의),부결(공동발의),수정안반영폐기(공동발의),대안반영폐기(공동발의),폐기(공동발의),임기만료폐기(공동발의),회기불계속폐기(공동발의),기타(공동발의)
제19대,IDV9108J,진영,陳永,새누리당,서울 용산구,149,15,134,5,42,0,0,0,28,6,68,0,0,0,1,0,0,0,5,1,8,0,0,5,41,0,0,0,23,5,60,0,0
제19대,P2N4585G,김승남,金承南,민주통합당,전남 고흥군보성군,1128,59,1069,25,57,8,0,0,267,18,753,0,0,0,5,1,0,0,16,0,37,0,0,25,52,7,0,0,251,18,716,0,0
제19대,A3H7195R,박완주,朴完柱,민주통합당,충남 천안시을,517,60,457,12,23,6,1,0,142,9,324,0,0,1,0,0,0,0,17,1,41,0,0,11,23,6,1,0,125,8,283,0,0
제19대,MSY7784L,윤상현,尹相現,새누리당,인천 남구을,266,35,231,3,59,7,0,0,42,9,146,0,0,0,2,1,0,0,8,2,22,0,0,3,57,6,0,0,34,7,124,0,0
제19대,M0A1658U,윤호중,尹昊重,민주통합당,경기 구리시,771,43,728,6,26,6,0,0,207,45,481,0,0,0,0,2,0,0,11,10,20,0,0,6,26,4,0,0,196,35,461,0,0
제19대,VHK3402G,정우택,鄭宇澤,새누리당,충북 청주시상당구,371,37,334,3,48,7,0,0,99,15,199,0,0,0,0,0,0,0,7,4,26,0,0,3,48,7,0,0,92,11,173,0,0
제19대,VNF2868Z,조원진,趙源震,새누리당,대구 달서구병,422,38,384,11,72,5,0,0,110,12,212,0,0,2,3,1,0,0,9,1,22,0,0,9,69,4,0,0,101,11,190,0,0
제19대,68P7228G,진선미,陳善美,민주통합당,비례대표,691,72,619,10,20,6,0,0,170,8,477,0,0,0,2,2,0,0,17,0,51,0,0,10,18,4,0,0,153,8,426,0,0
제19대,TKJ4800F,서영교,徐瑛敎,민주통합당,서울 중랑구갑,831,105,726,15,40,8,0,0,175,10,583,0,0,0,3,1,0,0,18,1,82,0,0,15,37,7,0,0,157,9,501,0,0
제19대,3ZR4438W,이인영,李仁榮,민주통합당,서울 구로구갑,615,38,577,5,29,7,0,0,131,9,434,0,0,0,3,0,0,0,6,1,28,0,0,5,26,7,0,0,125,8,406,0,0
제19대,NS06841K,이철우,李喆雨,새누리당,경북 김천시,618,49,569,15,73,15,1,0,152,10,352,0,0,0,4,0,0,0,10,1,34,0,0,15,69,15,1,0,142,9,318,0,0
제19대,JQA21112,한기호,韓起鎬,새누리당,강원 철원군화천군양구군인제군,495,35,460,10,61,9,1,0,128,12,274,0,0,0,2,0,0,0,11,0,22,0,0,10,59,9,1,0,117,12,252,0,0
제19대,PAB29217,김성찬,金盛贊,새누리당,경남 창원시진해구,721,42,679,12,69,7,0,0,194,17,422,0,0,3,4,1,0,0,7,1,26,0,0,9,65,6,0,0,187,16,396,0,0
제19대,RYL1698T,문병호,文炳浩,민주통합당,인천 부평구갑,620,35,585,6,31,10,0,0,157,12,404,0,0,0,1,3,0,0,3,1,27,0,0,6,30,7,0,0,154,11,377,0,0
제19대,S824682L,박홍근,朴洪根,민주통합당,서울 중랑구을,1740,83,1657,47,66,13,0,0,465,32,1117,0,0,1,3,0,0,0,10,3,66,0,0,46,63,13,0,0,455,29,1051,0,0
제19대,BM63269Y,전해철,全海澈,민주통합당,경기 안산시상록구갑,568,46,522,10,31,3,0,0,140,6,378,0,0,0,3,0,0,0,17,0,26,0,0,10,28,3,0,0,123,6,352,0,0
제19대,XPP2564T,한정애,韓貞愛,민주통합당,비례대표,692,52,640,17,31,4,0,0,167,5,468,0,0,1,2,0,0,0,15,0,34,0,0,16,29,4,0,0,152,5,434,0,0
제19대,3O66539X,김성곤,金星坤,민주통합당,전남 여수시갑,2294,62,2232,58,108,33,0,0,614,42,1439,0,0,2,2,0,0,0,16,3,39,0,0,56,106,33,0,0,598,39,1400,0,0
제19대,Q9H5708M,김진표,金振杓,민주통합당,경기 수원시정,128,15,113,4,4,1,0,0,47,2,70,0,0,1,1,0,0,0,3,0,10,0,0,3,3,1,0,0,44,2,60,0,0
제19대,F363102R,양창영,楊昶榮,새누리당,비례대표,352,36,316,3,10,3,0,0,71,7,258,0,0,0,0,0,0,0,8,2,26,0,0,3,10,3,0,0,63,5,232,0,0
제19대,O7R5461J,윤후덕,尹厚德,민주통합당,경기 파주시갑,1052,49,1003,13,52,9,0,0,297,14,667,0,0,0,0,0,0,0,18,1,30,0,0,13,52,9,0,0,279,13,637,0,0
제19대,SAA7309Q,이한성,李翰成,새누리당,경북 문경시예천군,1914,53,1861,20,117,20,1,0,524,52,1180,0,0,0,1,1,0,0,13,1,37,0,0,20,116,19,1,0,511,51,1143,0,0
제19대,V8I36226,장병완,張秉浣,민주통합당,광주 남구,696,73,623,31,24,7,0,0,184,16,434,0,0,1,3,0,0,0,12,1,56,0,0,30,21,7,0,0,172,15,378,0,0
제19대,IRQ5741O,나성린,羅城麟,새누리당,부산 부산진구갑,454,60,394,7,60,2,0,0,133,35,217,0,0,0,2,0,0,0,25,18,15,0,0,7,58,2,0,0,108,17,202,0,0
제19대,4CH4157I,송영근,宋泳勤,새누리당,비례대표,1037,73,964,23,98,18,0,0,285,28,585,0,0,0,5,3,0,0,15,4,46,0,0,23,93,15,0,0,270,24,539,0,0
제19대,ZRF3039U,윤재옥,尹在玉,새누리당,대구 달서구을,498,42,456,12,59,6,0,0,124,11,286,0,0,2,1,0,0,0,12,1,26,0,0,10,58,6,0,0,112,10,260,0,0
제19대,WCA3290J,이완구,李完九,새누리당,충남 부여군청양군,115,4,111,7,4,1,0,0,37,0,66,0,0,0,0,0,0,0,2,0,2,0,0,7,4,1,0,0,35,0,64,0,0
제19대,HJI9845B,이인제,李仁濟,자유선진당,충남 논산시계룡시금산군,349,9,340,14,54,2,1,0,92,7,179,0,0,0,1,0,0,0,2,0,6,0,0,14,53,2,1,0,90,7,173,0,0
제19대,XGQ9659R,이한구,李漢久,새누리당,대구 수성구갑,152,60,92,3,35,2,0,0,22,8,82,0,0,3,33,1,0,0,5,2,16,0,0,0,2,1,0,0,17,6,66,0,0
제19대,X7I4680R,김기현,金起炫,새누리당,울산 남구을,125,16,109,2,40,2,0,0,32,5,44,0,0,0,1,1,0,0,3,0,11,0,0,2,39,1,0,0,29,5,33,0,0
제19대,BN49469V,신경민,辛京珉,민주통합당,서울 영등포구을,919,60,859,18,37,12,0,0,212,13,627,0,0,3,0,1,0,0,6,2,48,0,0,15,37,11,0,0,206,11,579,0,0
제19대,V822582Y,이목희,李穆熙,민주통합당,서울 금천구,812,47,765,18,27,4,0,0,243,9,511,0,0,0,0,1,0,0,17,1,28,0,0,18,27,3,0,0,226,8,483,0,0
제19대,9ZP9014Q,이해찬,李海瓚,민주통합당,세종특별자치시,228,8,220,1,9,2,0,0,55,2,159,0,0,0,0,0,0,0,3,0,5,0,0,1,9,2,0,0,52,2,154,0,0
제19대,0827740Q,노웅래,盧雄來,민주통합당,서울 마포구갑,573,71,502,8,17,5,0,0,116,11,416,0,0,1,1,2,0,0,20,0,47,0,0,7,16,3,0,0,96,11,369,0,0
제19대,AIP8367M,배기운,裵奇雲,민주통합당,전남 나주시화순군,2652,92,2560,90,144,28,0,0,741,40,1609,0,0,18,8,1,0,0,19,3,43,0,0,72,136,27,0,0,722,37,1566,0,0
제19대,4Y54669I,서청원,徐淸源,새누리당,경기 화성시갑,133,6,127,2,11,1,0,0,33,2,84,0,0,0,1,0,0,0,0,0,5,0,0,2,10,1,0,0,33,2,79,0,0
제19대,QT984813,신학용,辛鶴用,민주통합당,인천 계양구갑,362,40,322,12,13,10,0,0,106,11,210,0,0,2,2,0,0,0,12,0,24,0,0,10,11,10,0,0,94,11,186,0,0
제19대,TZD17894,원유철,元裕哲,새누리당,경기 평택시갑,278,16,262,7,52,5,1,0,53,4,156,0,0,0,2,1,0,0,3,0,10,0,0,7,50,4,1,0,50,4,146,0,0
제19대,ETV7396M,윤명희,尹明熙,새누리당,비례대표,1124,146,978,19,101,17,0,0,300,18,669,0,0,6,15,1,0,0,35,2,87,0,0,13,86,16,0,0,265,16,582,0,0
제19대,ZBL82850,이종훈,李宗勳,새누리당,경기 성남시분당구갑,442,21,421,16,65,17,0,0,121,11,212,0,0,0,1,1,0,0,8,0,11,0,0,16,64,16,0,0,113,11,201,0,0
제19대,YSL5919D,장정은,張廷銀,새누리당,비례대표,53,5,48,0,0,0,0,0,4,0,49,0,0,0,0,0,0,0,0,0,5,0,0,0,0,0,0,0,4,0,44,0,0
제19대,SPF4589S,장하나,張하나,민주통합당,비례대표,1375,69,1306,19,52,14,0,0,367,20,903,0,0,0,2,0,0,0,9,0,58,0,0,19,50,14,0,0,358,20,845,0,0
제19대,SIL7886Y,조현룡,趙顯龍,새누리당,경남 의령군함안군합천군,339,23,316,9,60,1,0,0,107,12,150,0,0,0,3,0,0,0,12,0,8,0,0,9,57,1,0,0,95,12,142,0,0
제19대,E6S73230,김영주,金永柱,자유선진당,비례대표,351,15,336,13,53,1,0,0,97,8,179,0,0,2,0,0,0,0,2,1,10,0,0,11,53,1,0,0,95,7,169,0,0
제19대,1C04271Z,김영환,金榮煥,민주통합당,경기 안산시상록구을,331,25,306,7,21,6,0,0,96,7,194,0,0,0,1,0,0,0,4,1,19,0,0,7,20,6,0,0,92,6,175,0,0
제19대,N6C1899K,김진태,金鎭台,새누리당,강원 춘천시,367,19,348,9,64,3,0,0,109,5,177,0,0,0,1,0,0,0,8,0,10,0,0,9,63,3,0,0,101,5,167,0,0
제19대,9VR65006,윤영석,尹永碩,새누리당,경남 양산시,468,41,427,11,59,3,0,0,134,8,253,0,0,0,2,0,0,0,13,2,24,0,0,11,57,3,0,0,121,6,229,0,0
제19대,S7E4736F,윤진식,尹鎭植,새누리당,충북 충주시,232,5,227,7,45,13,0,0,70,7,90,0,0,1,0,0,0,0,2,0,2,0,0,6,45,13,0,0,68,7,88,0,0
제19대,CFE3998F,이상직,李相稷,민주통합당,전북 전주시완산구을,1022,45,977,16,62,12,0,0,265,20,647,0,0,0,1,0,0,0,9,0,35,0,0,16,61,12,0,0,256,20,612,0,0
제19대,C8L89785,이에리사,李에리사,새누리당,비례대표,938,28,910,12,78,16,0,0,266,20,546,0,0,0,1,0,0,0,6,0,21,0,0,12,77,16,0,0,260,20,525,0,0
제19대,1KD95875,함진규,咸珍圭,새누리당,경기 시흥시갑,753,116,637,11,78,11,0,0,215,18,420,0,0,3,4,0,0,0,29,3,77,0,0,8,74,11,0,0,186,15,343,0,0
제19대,23D73143,경대수,慶大秀,새누리당,충북 증평군진천군괴산군음성군,462,50,412,15,65,5,0,0,127,8,242,0,0,0,9,0,0,0,13,0,28,0,0,15,56,5,0,0,114,8,214,0,0
제19대,O6D8329R,민홍철,閔洪喆,민주통합당,경남 김해시갑,1096,44,1052,18,49,6,0,0,309,23,691,0,0,0,3,1,0,0,12,2,26,0,0,18,46,5,0,0,297,21,665,0,0
제19대,XBT9550Q,우원식,禹元植,민주통합당,서울 노원구을,838,33,805,8,31,5,0,0,210,8,576,0,0,0,1,0,0,0,5,0,27,0,0,8,30,5,0,0,205,8,549,0,0
제19대,8WV8289I,이완영,李完永,새누리당,경북 고령군성주군칠곡군,842,38,804,26,74,30,0,0,248,18,446,0,0,0,3,0,0,0,13,0,22,0,0,26,71,30,0,0,235,18,424,0,0
제19대,NG55346W,전병헌,田炳憲,민주통합당,서울 동작구갑,691,63,628,10,29,2,0,0,177,9,464,0,0,0,2,1,0,0,18,1,41,0,0,10,27,1,0,0,159,8,423,0,0
제19대,0WM96169,전정희,全正姬,민주통합당,전북 익산시을,1044,60,984,19,39,13,0,0,300,31,642,0,0,0,2,1,0,0,21,2,34,0,0,19,37,12,0,0,279,29,608,0,0
제19대,T2K9554I,홍문종,洪文鐘,새누리당,경기 의정부시을,257,16,241,7,47,1,0,0,64,7,131,0,0,1,1,0,0,0,5,0,9,0,0,6,46,1,0,0,59,7,122,0,0
제19대,2WQ6656P,김세연,金世淵,새누리당,부산 금정구,985,45,940,24,89,5,0,0,258,25,584,0,0,1,5,0,0,0,10,1,28,0,0,23,84,5,0,0,248,24,556,0,0
제19대,SSF6805Q,염동열,廉東烈,새누리당,강원 태백시영월군평창군정선군,676,34,642,19,68,11,1,0,163,9,405,0,0,0,2,0,0,0,6,1,25,0,0,19,66,11,1,0,157,8,380,0,0
제19대,GN240959,노회찬,魯會燦,통합진보당,서울 노원구병,119,15,104,0,1,1,0,0,27,1,89,0,0,0,0,0,0,0,6,0,9,0,0,0,1,1,0,0,21,1,80,0,0
제19대,53Y1887H,최규성,崔圭成,민주통합당,전북 김제시완주군,1238,65,1173,47,66,9,0,0,354,28,734,0,0,11,15,1,0,0,9,1,28,0,0,36,51,8,0,0,345,27,706,0,0
제19대,KR14136C,홍영표,洪永杓,민주통합당,인천 부평구을,539,48,491,13,16,8,0,0,149,10,343,0,0,8,1,1,0,0,17,1,20,0,0,5,15,7,0,0,132,9,323,0,0
제19대,R365233W,홍철호,洪哲鎬,새누리당,경기 김포시,362,21,341,3,14,2,0,0,78,15,250,0,0,0,0,0,0,0,2,1,18,0,0,3,14,2,0,0,76,14,232,0,0
제19대,YKW37422,권은희,權垠希,새정치민주연합,광주 광산구을,73,11,62,1,1,1,0,0,13,2,55,0,0,0,0,1,0,0,2,0,8,0,0,1,1,0,0,0,11,2,47,0,0
제19대,7YL9580G,김현,金玄,민주통합당,비례대표,475,24,451,10,20,2,0,0,111,9,323,0,0,0,1,0,0,0,6,1,16,0,0,10,19,2,0,0,105,8,307,0,0
제19대,05179989,유승우,柳勝優,새누리당,경기 이천시,1011,65,946,56,90,32,0,0,259,29,545,0,0,4,4,0,0,0,12,1,44,0,0,52,86,32,0,0,247,28,501,0,0
제19대,1Y73132H,김상훈,金相勳,새누리당,대구 서구,675,45,630,19,92,9,0,0,185,17,353,0,0,1,3,1,0,0,13,2,25,0,0,18,89,8,0,0,172,15,328,0,0
제19대,2796588I,김용남,金勇男,새누리당,경기 수원시병,81,23,58,2,4,1,0,0,12,1,61,0,0,1,2,0,0,0,3,1,16,0,0,1,2,1,0,0,9,0,45,0,0
제19대,EJS5449A,류지영,柳知영,새누리당,비례대표,1166,103,1063,33,103,4,0,0,312,26,688,0,0,6,5,0,0,0,34,0,58,0,0,27,98,4,0,0,278,26,630,0,0
제19대,8V02734T,서용교,徐瑢敎,새누리당,부산 남구을,839,25,814,31,85,31,0,0,228,29,435,0,0,1,2,0,0,0,7,0,15,0,0,30,83,31,0,0,221,29,420,0,0
제19대,OIU86868,고희선,高羲善,새누리당,경기 화성시갑,273,12,261,8,49,4,0,0,64,14,134,0,0,0,1,0,0,0,2,0,9,0,0,8,48,4,0,0,62,14,125,0,0
제19대,UGH6481E,김상희,金相姬,민주통합당,경기 부천시소사구,928,106,822,11,37,5,0,0,259,12,604,0,0,1,1,1,0,0,36,0,67,0,0,10,36,4,0,0,223,12,537,0,0
제19대,QZU9232M,김재원,金在原,새누리당,경북 군위군의성군청송군,516,49,467,24,67,4,0,0,137,8,276,0,0,0,9,2,0,0,8,0,30,0,0,24,58,2,0,0,129,8,246,0,0
제19대,8GH3836P,신문식,申文植,새정치민주연합,비례대표,42,1,41,0,0,0,0,0,9,1,32,0,0,0,0,0,0,0,0,0,1,0,0,0,0,0,0,0,9,1,31,0,0
제19대,W136716J,이재균,李在均,새누리당,부산 영도구,99,5,94,3,38,0,0,0,19,3,36,0,0,0,2,0,0,0,2,0,1,0,0,3,36,0,0,0,17,3,35,0,0
제19대,AMF4093D,김용태,金容兌,새누리당,서울 양천구을,288,25,263,10,46,9,0,0,63,5,155,0,0,0,0,0,0,0,9,0,16,0,0,10,46,9,0,0,54,5,139,0,0
제19대,EUR98126,박맹우,朴孟雨,새누리당,울산 남구을,259,15,244,1,7,0,0,0,57,18,176,0,0,0,0,0,0,0,4,2,9,0,0,1,7,0,0,0,53,16,167,0,0
제19대,JMY9959W,윤관석,尹官石,민주통합당,인천 남동구을,1572,87,1485,21,88,17,0,0,436,29,981,0,0,0,3,1,0,0,29,2,52,0,0,21,85,16,0,0,407,27,929,0,0
제19대,VE469451,최재성,崔宰誠,민주통합당,경기 남양주시갑,616,35,581,10,17,6,0,0,133,40,410,0,0,0,0,2,0,0,5,2,26,0,0,10,17,4,0,0,128,38,384,0,0
제19대,5JA4781U,김영록,金瑛錄,민주통합당,전남 해남군완도군진도군,1385,116,1269,48,94,15,0,0,345,44,839,0,0,1,4,0,0,0,29,6,76,0,0,47,90,15,0,0,316,38,763,0,0
제19대,J2O8643H,도종환,都鍾煥,민주통합당,비례대표,611,35,576,15,24,8,0,0,168,13,383,0,0,3,1,1,0,0,9,0,21,0,0,12,23,7,0,0,159,13,362,0,0
제19대,S8431719,박영선,朴映宣,민주통합당,서울 구로구을,306,58,248,4,16,3,0,0,59,8,216,0,0,0,1,0,0,0,2,0,55,0,0,4,15,3,0,0,57,8,161,0,0
제19대,8BF5855P,박지원,朴智元,민주통합당,전남 목포시,421,18,403,4,13,4,0,0,113,12,275,0,0,0,0,0,0,0,2,0,16,0,0,4,13,4,0,0,111,12,259,0,0
제19대,ZGA4092Y,정용기,鄭容起,새누리당,대전 대덕구,177,13,164,3,7,1,0,0,31,4,131,0,0,0,4,0,0,0,5,0,4,0,0,3,3,1,0,0,26,4,127,0,0
제19대,Z5V67692,홍지만,洪志晩,새누리당,대구 달서구갑,1092,30,1062,24,102,12,0,0,325,45,584,0,0,0,1,0,0,0,12,3,14,0,0,24,101,12,0,0,313,42,570,0,0
제19대,Z206474J,서상기,徐相箕,새누리당,대구 북구을,736,39,697,16,74,9,0,0,157,14,466,0,0,2,6,0,0,0,5,0,26,0,0,14,68,9,0,0,152,14,440,0,0
제19대,YUV9402W,송호창,宋皓彰,민주통합당,경기 의왕시과천시,387,23,364,2,19,1,0,0,100,6,259,0,0,0,0,0,0,0,6,0,17,0,0,2,19,1,0,0,94,6,242,0,0
제19대,V429892C,정성호,鄭成湖,민주통합당,경기 양주시동두천시,1547,66,1481,20,68,14,0,0,447,47,951,0,0,1,2,2,0,0,24,3,34,0,0,19,66,12,0,0,423,44,917,0,0
제19대,C7Z8238W,황영철,黃永哲,새누리당,강원 홍천군횡성군,624,45,579,18,72,11,0,0,188,21,314,0,0,2,7,3,0,0,16,0,17,0,0,16,65,8,0,0,172,21,297,0,0
제19대,EI023764,남경필,南景弼,새누리당,경기 수원시병,428,18,410,14,60,2,0,0,133,14,205,0,0,1,2,0,0,0,3,0,12,0,0,13,58,2,0,0,130,14,193,0,0
제19대,9HH8057S,박성호,朴成浩,새누리당,경남 창원시의창구,1033,76,957,11,87,8,0,0,303,35,589,0,0,2,2,0,0,0,20,3,49,0,0,9,85,8,0,0,283,32,540,0,0
제19대,TS24083U,박성효,朴城孝,새누리당,대전 대덕구,228,17,211,13,49,13,0,0,55,4,94,0,0,1,3,0,0,0,4,0,9,0,0,12,46,13,0,0,51,4,85,0,0
제19대,5XZ8670E,신장용,申長容,민주통합당,경기 수원시을,490,27,463,11,28,11,0,0,145,11,284,0,0,0,1,2,0,0,10,1,13,0,0,11,27,9,0,0,135,10,271,0,0
제19대,SEK1881Q,유재중,柳在仲,새누리당,부산 수영구,418,38,380,18,59,1,0,0,107,5,228,0,0,2,2,0,0,0,8,0,26,0,0,16,57,1,0,0,99,5,202,0,0
제19대,TIS61927,양승조,梁承晁,민주통합당,충남 천안시갑,1029,162,867,25,50,12,0,0,282,23,637,0,0,1,8,0,0,0,56,1,96,0,0,24,42,12,0,0,226,22,541,0,0
제19대,16D7652C,이원욱,李元旭,민주통합당,경기 화성시을,1011,69,942,18,31,8,0,0,254,21,679,0,0,1,1,3,0,0,17,3,44,0,0,17,30,5,0,0,237,18,635,0,0
제19대,BWD92364,이찬열,李燦烈,민주통합당,경기 수원시갑,1379,110,1269,40,52,6,0,0,374,35,872,0,0,1,1,1,0,0,40,5,62,0,0,39,51,5,0,0,334,30,810,0,0
제19대,WQ12168I,임수경,林秀卿,민주통합당,비례대표,779,52,727,16,33,4,0,0,194,20,512,0,0,0,4,1,0,0,15,0,32,0,0,16,29,3,0,0,179,20,480,0,0
제19대,DCN7433W,정세균,丁世均,민주통합당,서울 종로구,424,12,412,11,17,2,0,0,118,9,267,0,0,0,0,0,0,0,5,0,7,0,0,11,17,2,0,0,113,9,260,0,0
제19대,WCN6711J,손인춘,孫仁春,새누리당,비례대표,971,55,916,15,72,11,0,0,285,24,564,0,0,0,2,1,0,0,13,3,36,0,0,15,70,10,0,0,272,21,528,0,0
제19대,KKD3190X,신의진,申宜眞,새누리당,비례대표,504,54,450,11,59,11,0,0,131,12,280,0,0,1,2,0,0,0,9,0,42,0,0,10,57,11,0,0,122,12,238,0,0
제19대,FRN1867O,홍익표,洪翼杓,민주통합당,서울 성동구을,249,44,205,2,7,2,0,0,57,8,173,0,0,0,0,0,0,0,7,5,32,0,0,2,7,2,0,0,50,3,141,0,0
제19대,RO47676W,박원석,朴元錫,통합진보당,비례대표,527,42,485,5,11,7,0,0,109,8,387,0,0,0,0,0,0,0,8,2,32,0,0,5,11,7,0,0,101,6,355,0,0
제19대,0A02586D,박혜자,朴惠子,민주통합당,광주 서구갑,348,44,304,5,11,3,0,0,92,2,235,0,0,2,1,0,0,0,11,0,30,0,0,3,10,3,0,0,81,2,205,0,0
제19대,CT85313K,서병수,徐秉洙,새누리당,부산 해운대구기장군갑,133,17,116,2,40,0,0,0,27,4,60,0,0,0,1,0,0,0,4,0,12,0,0,2,39,0,0,0,23,4,48,0,0
제19대,6YO6092T,안덕수,安德壽,새누리당,인천 서구강화군을,307,13,294,11,47,2,0,0,83,4,160,0,0,0,1,0,0,0,8,0,4,0,0,11,46,2,0,0,75,4,156,0,0
제19대,SNJ6318D,김무성,金武星,새누리당,부산 영도구,174,6,168,3,14,1,0,0,39,4,113,0,0,0,0,0,0,0,1,0,5,0,0,3,14,1,0,0,38,4,108,0,0
제19대,ZC87486D,김선동,金先東,통합진보당,전남 순천시곡성군,199,19,180,2,3,0,0,0,34,2,158,0,0,0,0,0,0,0,2,0,17,0,0,2,3,0,0,0,32,2,141,0,0
제19대,3538970J,김을동,金乙東,새누리당,서울 송파구병,1092,36,1056,36,79,20,0,0,293,32,632,0,0,2,1,3,0,0,7,1,22,0,0,34,78,17,0,0,286,31,610,0,0
제19대,TVF3669B,김태흠,金泰欽,새누리당,충남 보령시서천군,435,23,412,5,67,1,0,0,90,14,258,0,0,0,3,0,0,0,5,1,14,0,0,5,64,1,0,0,85,13,244,0,0
제19대,OW53107J,설훈,薛勳,민주통합당,경기 부천시원미구을,421,34,387,12,18,3,0,0,99,20,269,0,0,1,4,0,0,0,15,5,9,0,0,11,14,3,0,0,84,15,260,0,0
제19대,EED3932M,신동우,申東雨,새누리당,서울 강동구갑,347,16,331,7,51,2,0,0,76,6,205,0,0,0,2,0,0,0,4,0,10,0,0,7,49,2,0,0,72,6,195,0,0
제19대,FGX4881A,심재철,沈在哲,새누리당,경기 안양시동안구을,434,102,332,6,42,3,0,0,106,14,263,0,0,1,0,2,0,0,36,7,56,0,0,5,42,1,0,0,70,7,207,0,0
제19대,EBU8493R,이미경,李美卿,민주통합당,,1001,19,982,12,36,8,0,0,292,15,638,0,0,0,0,0,0,0,6,0,13,0,0,12,36,8,0,0,286,15,625,0,0
제19대,QF159955,황인자,黃仁子,새누리당,비례대표,400,36,364,8,14,2,0,0,87,11,278,0,0,1,1,0,0,0,10,2,22,0,0,7,13,2,0,0,77,9,256,0,0
제19대,WXO1612R,김상민,金相珉,새누리당,비례대표,483,47,436,17,63,16,0,0,128,11,248,0,0,0,0,0,0,0,19,1,27,0,0,17,63,16,0,0,109,10,221,0,0
제19대,5Z47834I,김제식,金濟植,새누리당,충남 서산시태안군,288,20,268,3,9,0,0,0,63,5,208,0,0,0,2,0,0,0,6,0,12,0,0,3,7,0,0,0,57,5,196,0,0
제19대,1QC51111,김회선,金會瑄,새누리당,서울 서초구갑,285,22,263,11,41,3,0,0,72,6,152,0,0,3,0,0,0,0,5,0,14,0,0,8,41,3,0,0,67,6,138,0,0
제19대,E2O7996B,신기남,辛基南,민주통합당,서울 강서구갑,299,17,282,4,12,1,0,0,83,5,194,0,0,0,0,0,0,0,5,0,12,0,0,4,12,1,0,0,78,5,182,0,0
제19대,1599843H,이강후,李康厚,새누리당,강원 원주시을,556,47,509,10,61,4,1,0,146,21,313,0,0,0,0,0,1,0,21,2,23,0,0,10,61,4,0,0,125,19,290,0,0
제19대,ZX71333R,한선교,韓善敎,새누리당,경기 용인시병,417,59,358,18,53,6,0,0,98,12,230,0,0,4,2,2,0,0,16,1,34,0,0,14,51,4,0,0,82,11,196,0,0
제19대,PFM7673W,권은희,權恩嬉,새누리당,대구 북구갑,729,35,694,18,61,9,0,0,222,24,395,0,0,1,3,3,0,0,15,1,12,0,0,17,58,6,0,0,207,23,383,0,0
제19대,ZKU88693,김경협,金炅俠,민주통합당,경기 부천시원미구갑,718,45,673,18,22,5,0,0,176,17,480,0,0,1,2,0,0,0,16,1,25,0,0,17,20,5,0,0,160,16,455,0,0
제19대,PLR62452,김영우,金榮宇,새누리당,경기 포천시연천군,374,26,348,4,43,2,0,0,86,9,230,0,0,0,0,0,0,0,4,1,21,0,0,4,43,2,0,0,82,8,209,0,0
제19대,P0F1530P,김태호,金台鎬,새누리당,경남 김해시을,233,11,222,5,39,0,0,0,47,5,137,0,0,0,0,0,0,0,2,0,9,0,0,5,39,0,0,0,45,5,128,0,0
제19대,RMC1840P,신성범,愼聖範,새누리당,경남 산청군함양군거창군,554,35,519,8,65,4,0,0,143,6,328,0,0,2,6,1,0,0,10,1,15,0,0,6,59,3,0,0,133,5,313,0,0
제19대,TST4507I,안규백,安圭伯,민주통합당,서울 동대문구갑,1040,32,1008,17,43,13,0,0,251,20,696,0,0,1,6,0,0,0,7,0,18,0,0,16,37,13,0,0,244,20,678,0,0
제19대,9BE5694R,유승희,兪承希,민주통합당,서울 성북구갑,640,90,550,4,31,2,0,0,148,9,446,0,0,1,3,0,0,0,17,1,68,0,0,3,28,2,0,0,131,8,378,0,0
제19대,YNC4052A,김기준,金基俊,민주통합당,비례대표,757,83,674,6,35,8,0,0,213,12,483,0,0,2,3,0,0,0,27,0,51,0,0,4,32,8,0,0,186,12,432,0,0
제19대,PMU9608V,김태환,金泰煥,새누리당,경북 구미시을,411,14,397,11,64,3,0,0,123,8,202,0,0,0,2,0,0,0,4,0,8,0,0,11,62,3,0,0,119,8,194,0,0
제19대,YBM9779M,김한표,金漢杓,무소속,경남 거제시,894,82,812,22,86,4,0,0,240,18,524,0,0,0,6,1,0,0,16,1,58,0,0,22,80,3,0,0,224,17,466,0,0
제19대,ZA54991S,안민석,安敏錫,민주통합당,경기 오산시,786,69,717,16,19,4,0,0,215,14,518,0,0,0,2,0,0,0,15,0,52,0,0,16,17,4,0,0,200,14,466,0,0
제19대,IUZ2177I,정수성,鄭壽星,새누리당,경북 경주시,477,35,442,10,57,3,0,0,116,12,279,0,0,1,0,0,0,0,10,0,24,0,0,9,57,3,0,0,106,12,255,0,0
제19대,URV1689Q,추미애,秋美愛,민주통합당,서울 광진구을,609,30,579,7,20,3,0,0,155,16,408,0,0,1,0,0,0,0,4,1,24,0,0,6,20,3,0,0,151,15,384,0,0
제19대,JOY4394O,황주홍,黃柱洪,민주통합당,전남 장흥군강진군영암군,1312,139,1173,17,51,13,0,0,296,32,903,0,0,0,2,1,0,0,27,4,105,0,0,17,49,12,0,0,269,28,798,0,0
제19대,8SV6917G,주호영,朱豪英,새누리당,대구 수성구을,494,28,466,12,56,7,0,0,128,25,266,0,0,0,0,0,0,0,7,1,20,0,0,12,56,7,0,0,121,24,246,0,0
제19대,1PK82111,강기정,姜琪正,민주통합당,광주 북구갑,1212,70,1142,50,54,8,0,0,320,20,760,0,0,3,3,0,0,0,13,0,51,0,0,47,51,8,0,0,307,20,709,0,0
제19대,BLC8630L,박병석,朴炳錫,민주통합당,대전 서구갑,87,26,61,1,4,2,0,0,23,1,56,0,0,0,0,1,0,0,9,0,16,0,0,1,4,1,0,0,14,1,40,0,0
제19대,6DG91769,원혜영,元惠榮,민주통합당,경기 부천시오정구,577,39,538,13,17,8,0,0,130,15,394,0,0,0,0,1,0,0,8,0,30,0,0,13,17,7,0,0,122,15,364,0,0
제19대,0667420L,이윤석,李潤錫,민주통합당,전남 무안군신안군,813,32,781,35,44,12,0,0,220,21,481,0,0,2,0,0,0,0,9,0,21,0,0,33,44,12,0,0,211,21,460,0,0
제19대,D3V12361,이종진,李鐘鎭,새누리당,대구 달성군,655,22,633,12,61,3,0,0,174,15,390,0,0,0,1,0,0,0,9,0,12,0,0,12,60,3,0,0,165,15,378,0,0
제19대,V2R7430Z,이춘석,李春錫,민주통합당,전북 익산시갑,855,50,805,18,38,9,0,0,206,11,573,0,0,1,3,0,0,0,6,0,40,0,0,17,35,9,0,0,200,11,533,0,0
제19대,MBS2896E,이현재,李賢在,새누리당,경기 하남시,656,35,621,11,69,16,0,0,187,25,348,0,0,2,6,3,0,0,14,1,9,0,0,9,63,13,0,0,173,24,339,0,0
제19대,YS38221N,최민희,崔民熙,민주통합당,비례대표,1321,116,1205,17,57,15,0,0,352,17,863,0,0,1,7,0,0,0,35,1,72,0,0,16,50,15,0,0,317,16,791,0,0
제19대,CYD5815E,정갑윤,鄭甲潤,새누리당,울산 중구,736,22,714,14,73,19,0,0,176,22,432,0,0,0,2,0,0,0,5,0,15,0,0,14,71,19,0,0,171,22,417,0,0
제19대,TOU1222X,강창일,姜昌一,민주통합당,제주 제주시갑,1130,174,956,70,67,23,0,0,296,20,654,0,0,9,11,1,0,0,59,5,89,0,0,61,56,22,0,0,237,15,565,0,0
제19대,9LK1769G,김광진,金光珍,민주통합당,비례대표,1946,162,1784,45,80,17,0,0,502,53,1249,0,0,6,4,1,0,0,43,5,103,0,0,39,76,16,0,0,459,48,1146,0,0
제19대,K1Y45873,김종태,金鍾泰,새누리당,경북 상주시,648,25,623,13,66,7,0,0,155,20,387,0,0,0,1,0,0,0,11,1,12,0,0,13,65,7,0,0,144,19,375,0,0
제19대,9XB6464U,김현미,金賢美,민주통합당,경기 고양시일산서구,909,32,877,13,21,10,0,0,219,44,602,0,0,0,0,0,0,0,10,0,22,0,0,13,21,10,0,0,209,44,580,0,0
제19대,OK55632O,오영식,吳泳食,민주통합당,서울 강북구갑,556,24,532,15,28,5,0,0,165,6,337,0,0,2,6,0,0,0,8,0,8,0,0,13,22,5,0,0,157,6,329,0,0
제19대,YB364276,윤금순,尹今順,통합진보당,비례대표,0,0,0,0,0,0,0,0,0,0,0,0,0,0,0,0,0,0,0,0,0,0,0,0,0,0,0,0,0,0,0,0,0
제19대,I7R13867,이개호,李介昊,새정치민주연합,전남 담양군함평군영광군장성군,1427,40,1387,19,35,8,0,0,297,24,1044,0,0,0,0,0,0,0,12,0,28,0,0,19,35,8,0,0,285,24,1016,0,0
제19대,FJ03481D,최경환,崔炅煥,새누리당,경북 경산시청도군,91,6,85,3,35,0,0,0,17,1,35,0,0,0,0,0,0,0,2,0,4,0,0,3,35,0,0,0,15,1,31,0,0
제19대,U168240U,김근태,金瑾泰,새누리당,충남 부여군청양군,89,4,85,2,36,3,0,0,17,4,27,0,0,0,0,1,0,0,0,0,3,0,0,2,36,2,0,0,17,4,24,0,0
제19대,NKU2941B,김동완,金東完,새누리당,충남 당진시,553,26,527,16,63,3,0,0,130,18,323,0,0,1,3,1,0,0,3,4,14,0,0,15,60,2,0,0,127,14,309,0,0
제19대,R724713H,김재윤,金才允,민주통합당,제주 서귀포시,992,39,953,8,41,8,0,0,255,18,662,0,0,3,3,0,0,0,7,1,25,0,0,5,38,8,0,0,248,17,637,0,0
제19대,2385336L,정청래,鄭淸來,민주통합당,서울 마포구을,932,169,763,14,25,8,0,0,247,7,631,0,0,1,5,1,0,0,50,0,112,0,0,13,20,7,0,0,197,7,519,0,0
제19대,6AR6743G,김희국,金熙國,새누리당,대구 중구남구,474,29,445,11,52,2,0,0,139,11,259,0,0,0,0,0,0,0,11,1,17,0,0,11,52,2,0,0,128,10,242,0,0
제19대,P318485D,박민식,朴敏植,새누리당,부산 북구강서구갑,401,39,362,17,63,6,0,0,109,9,197,0,0,2,2,0,0,0,13,0,22,0,0,15,61,6,0,0,96,9,175,0,0
제19대,MRK4871S,유의동,兪義東,새누리당,경기 평택시을,212,12,200,7,14,1,0,0,36,3,151,0,0,1,3,0,0,0,4,0,4,0,0,6,11,1,0,0,32,3,147,0,0
제19대,D7L1937J,이병석,李秉錫,새누리당,경북 포항시북구,171,15,156,3,40,5,0,0,20,16,87,0,0,0,0,0,0,0,4,0,11,0,0,3,40,5,0,0,16,16,76,0,0
제19대,XC039067,이상규,李相奎,통합진보당,서울 관악구을,191,21,170,2,0,1,0,0,31,0,157,0,0,0,0,0,0,0,5,0,16,0,0,2,0,1,0,0,26,0,141,0,0
제19대,39938231,정문헌,鄭文憲,새누리당,강원 속초시고성군양양군,829,25,804,12,78,10,0,0,215,35,479,0,0,0,1,0,0,0,2,1,21,0,0,12,77,10,0,0,213,34,458,0,0
제19대,OTR59398,정미경,鄭美京,새누리당,경기 수원시을,104,13,91,0,3,0,0,0,13,1,87,0,0,0,0,0,0,0,0,0,13,0,0,0,3,0,0,0,13,1,74,0,0
제19대,V1849655,정의화,鄭義和,새누리당,부산 중구동구,382,19,363,5,51,5,0,0,106,11,204,0,0,0,1,1,0,0,6,0,11,0,0,5,50,4,0,0,100,11,193,0,0
제19대,W168182V,김관영,金寬永,민주통합당,전북 군산시,1090,119,971,15,49,12,0,0,308,50,656,0,0,5,0,1,0,0,33,14,66,0,0,10,49,11,0,0,275,36,590,0,0
제19대,DCR84445,김동철,金東喆,민주통합당,광주 광산구갑,738,85,653,31,49,9,0,0,190,11,448,0,0,1,4,1,0,0,30,3,46,0,0,30,45,8,0,0,160,8,402,0,0
제19대,S7O71101,김재연,金在姸,통합진보당,비례대표,131,12,119,0,0,1,0,0,29,0,101,0,0,0,0,0,0,0,2,0,10,0,0,0,0,1,0,0,27,0,91,0,0
제19대,RK22879B,박상은,朴商銀,새누리당,인천 중구동구옹진군,288,14,274,13,55,4,0,0,65,5,146,0,0,0,1,1,0,0,2,0,10,0,0,13,54,3,0,0,63,5,136,0,0
제19대,CAL85655,유기준,兪奇濬,새누리당,부산 서구,377,11,366,8,51,5,0,0,98,10,205,0,0,0,0,0,0,0,4,0,7,0,0,8,51,5,0,0,94,10,198,0,0
제19대,DN76694L,이용섭,李庸燮,민주통합당,광주 광산구을,199,20,179,2,9,4,0,0,48,7,129,0,0,0,1,0,0,0,9,0,10,0,0,2,8,4,0,0,39,7,119,0,0
제19대,MGE7194M,김광림,金光琳,새누리당,경북 안동시,397,33,364,8,44,7,0,0,99,24,215,0,0,0,0,0,0,0,13,1,19,0,0,8,44,7,0,0,86,23,196,0,0
제19대,DSU7667M,박대동,朴大東,새누리당,울산 북구,531,32,499,13,71,10,0,0,138,9,290,0,0,1,6,0,0,0,10,0,15,0,0,12,65,10,0,0,128,9,275,0,0
제19대,2QE48823,장윤석,張倫碩,새누리당,경북 영주시,436,38,398,13,54,5,0,0,83,12,269,0,0,1,2,3,0,0,6,0,26,0,0,12,52,2,0,0,77,12,243,0,0
제19대,SE71196I,정윤숙,鄭潤淑,새누리당,비례대표,4,0,4,0,0,0,0,0,0,0,4,0,0,0,0,0,0,0,0,0,0,0,0,0,0,0,0,0,0,0,4,0,0
제19대,PAQ11014,강창희,姜昌熙,새누리당,,41,3,38,2,0,0,0,0,9,0,30,0,0,1,0,0,0,0,1,0,1,0,0,1,0,0,0,0,8,0,29,0,0
제19대,EC57622S,김기식,金起式,민주통합당,비례대표,357,45,312,5,19,2,0,0,98,2,231,0,0,0,4,0,0,0,16,0,25,0,0,5,15,2,0,0,82,2,206,0,0
제19대,3ZP1685J,박기춘,朴起春,민주통합당,경기 남양주시을,337,64,273,22,27,4,0,0,112,7,165,0,0,1,1,1,0,0,29,3,29,0,0,21,26,3,0,0,83,4,136,0,0
제19대,EOY55268,최원식,崔元植,민주통합당,인천 계양구을,788,49,739,15,38,6,0,0,203,5,521,0,0,1,4,1,0,0,7,0,36,0,0,14,34,5,0,0,196,5,485,0,0
제19대,GD131760,홍문표,洪文杓,새누리당,충남 홍성군예산군,626,35,591,8,57,3,0,0,152,20,386,0,0,0,4,0,0,0,8,2,21,0,0,8,53,3,0,0,144,18,365,0,0
제19대,LH97552Q,김도읍,金度邑,새누리당,부산 북구강서구을,439,35,404,13,54,2,0,0,129,17,224,0,0,0,2,0,0,0,16,1,16,0,0,13,52,2,0,0,113,16,208,0,0
제19대,LXP1076C,김태원,金兌原,새누리당,경기 고양시덕양구을,1673,180,1493,18,107,14,0,0,471,41,1022,0,0,1,4,2,0,0,76,4,93,0,0,17,103,12,0,0,395,37,929,0,0
제19대,39P2522W,민병두,閔丙두,민주통합당,서울 동대문구을,457,89,368,5,10,5,0,0,124,14,299,0,0,0,0,2,0,0,24,1,62,0,0,5,10,3,0,0,100,13,237,0,0
제19대,5TQ6306B,박수현,朴洙賢,민주통합당,충남 공주시,903,30,873,9,34,8,0,0,274,15,563,0,0,0,2,0,0,0,9,1,18,0,0,9,32,8,0,0,265,14,545,0,0
제19대,2Z21631Z,최재천,崔載千,민주통합당,서울 성동구갑,173,21,152,4,10,3,0,0,38,5,113,0,0,1,1,1,0,0,5,0,13,0,0,3,9,2,0,0,33,5,100,0,0
제19대,8D298611,문재인,文在寅,민주통합당,부산 사상구,64,4,60,2,1,3,0,0,12,2,44,0,0,0,0,0,0,0,0,0,4,0,0,2,1,3,0,0,12,2,40,0,0
제19대,24E9427D,박남춘,朴南春,민주통합당,인천 남동구갑,1713,114,1599,34,77,15,0,0,441,31,1115,0,0,5,2,1,0,0,33,2,71,0,0,29,75,14,0,0,408,29,1044,0,0
제19대,71M8132V,신상진,申相珍,새누리당,경기 성남시중원구,67,19,48,2,1,0,0,0,10,3,51,0,0,0,0,0,0,0,5,2,12,0,0,2,1,0,0,0,5,1,39,0,0
제19대,WDR7061Y,이종걸,李鍾杰,민주통합당,경기 안양시만안구,693,72,621,27,27,10,0,0,146,13,470,0,0,0,2,1,0,0,17,2,50,0,0,27,25,9,0,0,129,11,420,0,0
제19대,2UD1340H,김성주,金成柱,민주통합당,전북 전주시덕진구,843,47,796,7,40,10,0,0,276,12,498,0,0,0,3,0,0,0,24,1,19,0,0,7,37,10,0,0,252,11,479,0,0
제19대,CHN4172Q,김장실,金長實,새누리당,비례대표,546,38,508,6,69,3,0,0,150,20,298,0,0,0,5,0,0,0,11,0,22,0,0,6,64,3,0,0,139,20,276,0,0
제19대,04T3751T,남인순,南仁順,민주통합당,비례대표,953,128,825,11,29,7,0,0,294,11,601,0,0,1,5,1,0,0,59,2,60,0,0,10,24,6,0,0,235,9,541,0,0
제19대,0767470D,이낙연,李洛淵,민주통합당,전남 담양군함평군영광군장성군,954,124,830,23,38,12,0,0,274,19,588,0,0,10,5,1,0,0,38,3,67,0,0,13,33,11,0,0,236,16,521,0,0
제19대,ZP141168,김용익,金容益,민주통합당,비례대표,633,45,588,10,25,4,0,0,181,3,410,0,0,0,4,0,0,0,15,0,26,0,0,10,21,4,0,0,166,3,384,0,0
제19대,H337332S,오신환,吳晨煥,새누리당,서울 관악구을,64,9,55,0,0,1,0,0,8,1,54,0,0,0,0,0,0,0,0,0,9,0,0,0,0,1,0,0,8,1,45,0,0
제19대,PWU27609,유승민,劉承旼,새누리당,대구 동구을,502,13,489,8,49,8,0,0,124,12,301,0,0,0,0,1,0,0,3,1,8,0,0,8,49,7,0,0,121,11,293,0,0
제19대,63J3777V,유정복,劉正福,새누리당,경기 김포시,80,16,64,2,35,0,0,0,17,4,22,0,0,0,0,0,0,0,4,0,12,0,0,2,35,0,0,0,13,4,10,0,0
제19대,4HB8518T,박근혜,朴槿惠,새누리당,비례대표,19,0,19,1,3,0,0,0,7,1,7,0,0,0,0,0,0,0,0,0,0,0,0,1,3,0,0,0,7,1,7,0,0
제19대,IQ54138I,박인숙,朴仁淑,새누리당,서울 송파구갑,1500,137,1363,28,109,24,0,0,412,43,884,0,0,0,5,3,0,0,36,6,87,0,0,28,104,21,0,0,376,37,797,0,0
제19대,FPX1564S,안홍준,安鴻俊,새누리당,경남 창원시마산회원구,920,121,799,29,80,13,0,0,229,16,553,0,0,2,5,0,0,0,27,4,83,0,0,27,75,13,0,0,202,12,470,0,0
제19대,EVH1507C,이헌승,李憲昇,새누리당,부산 부산진구을,458,29,429,6,67,3,0,0,112,10,260,0,0,0,8,0,0,0,5,0,16,0,0,6,59,3,0,0,107,10,244,0,0
제19대,5YX7831C,정몽준,鄭夢準,새누리당,서울 동작구을,86,3,83,3,38,1,0,0,12,2,30,0,0,0,0,0,0,0,0,0,3,0,0,3,38,1,0,0,12,2,27,0,0
제19대,NTT8182Q,김민기,金敏基,민주통합당,경기 용인시을,684,66,618,13,26,11,0,0,192,11,431,0,0,2,4,1,0,0,28,0,31,0,0,11,22,10,0,0,164,11,400,0,0
제19대,OTE19384,박명재,朴明在,새누리당,경북 포항시남구울릉군,651,71,580,10,29,4,0,0,146,24,438,0,0,0,1,0,0,0,10,4,56,0,0,10,28,4,0,0,136,20,382,0,0
제19대,VXQ28579,심재권,沈載權,민주통합당,서울 강동구을,437,51,386,8,26,8,0,0,90,7,298,0,0,1,7,1,0,0,4,0,38,0,0,7,19,7,0,0,86,7,260,0,0
제19대,MOW97559,전순옥,全順玉,민주통합당,비례대표,1429,71,1358,12,65,15,0,0,393,25,919,0,0,3,2,0,0,0,17,4,45,0,0,9,63,15,0,0,376,21,874,0,0
제19대,3MR75193,강은희,姜恩姬,새누리당,비례대표,937,90,847,16,99,11,1,0,263,24,523,0,0,2,2,0,0,0,28,1,57,0,0,14,97,11,1,0,235,23,466,0,0
제19대,1WE5693J,김태년,金太年,민주통합당,경기 성남시수정구,560,45,515,9,24,5,0,0,145,3,374,0,0,0,1,0,0,0,20,0,24,0,0,9,23,5,0,0,125,3,350,0,0
제19대,IYD4143Y,문희상,文喜相,민주통합당,경기 의정부시갑,212,9,203,10,8,2,0,0,49,11,132,0,0,2,1,0,0,0,2,0,4,0,0,8,7,2,0,0,47,11,128,0,0
제19대,8DK7238W,백재현,白在鉉,민주통합당,경기 광명시갑,1006,83,923,25,30,12,0,0,278,25,636,0,0,4,0,2,0,0,13,4,60,0,0,21,30,10,0,0,265,21,576,0,0
제19대,MO52543L,변재일,卞在一,민주통합당,충북 청원군,728,75,653,14,23,7,0,0,203,26,455,0,0,4,1,0,0,0,15,1,54,0,0,10,22,7,0,0,188,25,401,0,0
제19대,0XK21509,안효대,安孝大,새누리당,울산 동구,427,71,356,15,56,10,0,0,120,4,222,0,0,8,6,8,0,0,20,0,29,0,0,7,50,2,0,0,100,4,193,0,0
제19대,IN328264,조정식,趙正湜,민주통합당,경기 시흥시을,1328,56,1272,38,47,8,0,0,321,32,882,0,0,0,2,0,0,0,9,8,37,0,0,38,45,8,0,0,312,24,845,0,0
제19대,SLW27496,나경원,羅景垣,새누리당,서울 동작구을,74,4,70,0,0,0,0,0,12,1,61,0,0,0,0,0,0,0,1,0,3,0,0,0,0,0,0,0,11,1,58,0,0
제19대,54Q4619H,박윤옥,朴允玉,새누리당,비례대표,506,26,480,4,22,4,0,0,134,7,335,0,0,0,1,0,0,0,8,0,17,0,0,4,21,4,0,0,126,7,318,0,0
제19대,S2C3781V,신계륜,申溪輪,민주통합당,서울 성북구을,187,58,129,18,8,12,0,0,39,6,104,0,0,9,5,12,0,0,11,0,21,0,0,9,3,0,0,0,28,6,83,0,0
제19대,YOG1280B,안철수,安哲秀,무소속,서울 노원구병,46,18,28,0,2,1,0,0,13,0,30,0,0,0,0,1,0,0,6,0,11,0,0,0,2,0,0,0,7,0,19,0,0
제19대,I7Z3068X,유성엽,柳成葉,무소속,전북 정읍시,1556,62,1494,25,81,13,0,0,380,31,1026,0,0,0,3,0,0,0,7,1,51,0,0,25,78,13,0,0,373,30,975,0,0
제19대,SZ51175J,이자스민,李자스민,새누리당,비례대표,667,42,625,17,63,2,0,0,186,22,377,0,0,1,1,0,0,0,13,2,25,0,0,16,62,2,0,0,173,20,352,0,0
제19대,T7Q3589Y,정진후,鄭鎭珝,통합진보당,비례대표,860,62,798,14,30,7,0,0,205,8,596,0,0,0,1,0,0,0,10,0,51,0,0,14,29,7,0,0,195,8,545,0,0
제19대,LGG10412,김현숙,金賢淑,새누리당,비례대표,441,65,376,6,59,2,0,0,157,12,205,0,0,0,5,0,0,0,38,0,22,0,0,6,54,2,0,0,119,12,183,0,0
제19대,QKY38290,여상규,余尙奎,새누리당,경남 사천시남해군하동군,399,23,376,11,69,7,0,0,107,18,187,0,0,2,3,0,0,0,9,0,9,0,0,9,66,7,0,0,98,18,178,0,0
제19대,URQ4401W,이재영,李宰榮,새누리당,비례대표,664,43,621,23,66,6,0,0,179,20,370,0,0,1,3,0,0,0,14,0,25,0,0,22,63,6,0,0,165,20,345,0,0
제19대,EIV1009T,정두언,鄭斗彦,새누리당,서울 서대문구을,209,5,204,0,15,0,0,0,48,4,142,0,0,0,0,0,0,0,2,0,3,0,0,0,15,0,0,0,46,4,139,0,0
제19대,BEF9073K,홍종학,洪鍾學,민주통합당,비례대표,1150,49,1101,12,43,11,0,0,282,34,768,0,0,0,0,2,0,0,16,3,28,0,0,12,43,9,0,0,266,31,740,0,0
제19대,XYI1730O,이이재,李利在,새누리당,강원 동해시삼척시,577,44,533,11,58,13,0,0,123,17,355,0,0,1,4,0,0,0,18,1,20,0,0,10,54,13,0,0,105,16,335,0,0
제19대,9EA39580,김명연,金明淵,새누리당,경기 안산시단원구갑,646,26,620,9,63,6,0,0,181,13,374,0,0,0,3,0,0,0,9,0,14,0,0,9,60,6,0,0,172,13,360,0,0
제19대,DW737223,김미희,金美希,통합진보당,경기 성남시중원구,275,14,261,1,9,3,0,0,56,2,204,0,0,0,0,0,0,0,4,0,10,0,0,1,9,3,0,0,52,2,194,0,0
제19대,HRG9655C,김희정,金姬廷,새누리당,부산 연제구,263,43,220,6,55,0,0,0,79,6,117,0,0,0,3,0,0,0,21,0,19,0,0,6,52,0,0,0,58,6,98,0,0
제19대,7R156073,박범계,朴範界,민주통합당,대전 서구을,403,20,383,8,18,5,0,0,74,21,277,0,0,2,1,0,0,0,5,1,11,0,0,6,17,5,0,0,69,20,266,0,0
제19대,R7753197,우윤근,禹潤根,민주통합당,전남 광양시구례군,751,67,684,34,31,3,0,0,169,12,502,0,0,3,0,0,0,0,16,1,47,0,0,31,31,3,0,0,153,11,455,0,0
제19대,G8Y72423,은수미,殷秀美,민주통합당,비례대표,495,27,468,10,23,1,0,0,134,3,324,0,0,0,3,0,0,0,4,0,20,0,0,10,20,1,0,0,130,3,304,0,0
제19대,ZPC8171Z,이상일,李相逸,새누리당,비례대표,404,37,367,21,52,0,0,0,98,11,222,0,0,0,0,0,0,0,16,2,19,0,0,21,52,0,0,0,82,9,203,0,0
제19대,WDS6044S,이채익,李埰益,새누리당,울산 남구갑,708,45,663,13,64,13,0,0,184,29,405,0,0,0,1,0,0,0,9,13,22,0,0,13,63,13,0,0,175,16,383,0,0
제19대,Z7S62260,임내현,林來玄,민주통합당,광주 북구을,513,41,472,20,20,5,0,0,158,14,296,0,0,1,2,0,0,0,10,0,28,0,0,19,18,5,0,0,148,14,268,0,0
제19대,Z6R3959C,조해진,曺海珍,새누리당,경남 밀양시창녕군,260,26,234,19,49,1,0,0,64,4,123,0,0,1,3,0,0,0,7,1,14,0,0,18,46,1,0,0,57,3,109,0,0
제19대,RUW8681N,황진하,黃震夏,새누리당,경기 파주시을,317,18,299,3,47,8,0,0,72,3,184,0,0,0,0,1,0,0,8,0,9,0,0,3,47,7,0,0,64,3,175,0,0
제19대,V4P1608C,문대성,文大成,새누리당,부산 사하구갑,698,30,668,12,35,10,0,0,205,21,415,0,0,0,0,0,0,0,1,2,27,0,0,12,35,10,0,0,204,19,388,0,0
제19대,N4R2421C,박덕흠,朴德欽,새누리당,충북 보은군옥천군영동군,523,30,493,7,60,7,0,0,123,17,309,0,0,0,1,0,0,0,5,2,22,0,0,7,59,7,0,0,118,15,287,0,0
제19대,6PK53823,서기호,徐基鎬,통합진보당,비례대표,470,38,432,4,10,3,0,0,101,8,344,0,0,0,2,0,0,0,11,0,25,0,0,4,8,3,0,0,90,8,319,0,0
제19대,7AN97172,이정현,李貞鉉,새누리당,전남 순천시곡성군,120,8,112,1,8,2,0,0,27,5,77,0,0,0,1,0,0,0,2,0,5,0,0,1,7,2,0,0,25,5,72,0,0
제19대,P303213F,정병국,鄭柄國,새누리당,경기 여주군양평군가평군,272,18,254,6,40,2,0,0,53,5,166,0,0,3,0,0,0,0,0,0,15,0,0,3,40,2,0,0,53,5,151,0,0
제19대,PYP5878A,한명숙,韓明淑,민주통합당,비례대표,641,47,594,18,26,4,0,0,192,8,393,0,0,0,0,0,0,0,20,0,27,0,0,18,26,4,0,0,172,8,366,0,0
제19대,Q5X4506F,황우여,黃祐呂,새누리당,,65,4,61,3,35,1,0,0,7,2,17,0,0,0,0,0,0,0,2,0,2,0,0,3,35,1,0,0,5,2,15,0,0
제19대,14M56632,강기윤,姜起潤,새누리당,경남 창원시성산구,1080,165,915,37,84,10,0,0,297,19,633,0,0,2,1,0,0,0,38,1,123,0,0,35,83,10,0,0,259,18,510,0,0
제19대,N4B7983W,길정우,吉炡宇,새누리당,서울 양천구갑,333,21,312,7,58,3,0,0,88,7,170,0,0,0,3,0,0,0,4,2,12,0,0,7,55,3,0,0,84,5,158,0,0
제19대,BQS2021C,김성태,金聖泰,새누리당,서울 강서구을,547,80,467,29,63,16,0,0,150,6,283,0,0,5,4,11,0,0,32,0,28,0,0,24,59,5,0,0,118,6,255,0,0
제19대,XZT48020,김정록,金正錄,새누리당,비례대표,949,49,900,16,85,15,0,0,260,22,551,0,0,1,3,0,0,0,21,0,24,0,0,15,82,15,0,0,239,22,527,0,0
제19대,Y4896106,백군기,白君基,민주통합당,비례대표,213,25,188,6,9,2,0,0,47,6,143,0,0,2,1,0,0,0,12,0,10,0,0,4,8,2,0,0,35,6,133,0,0
제19대,9FZ9424U,이석기,李石基,통합진보당,비례대표,102,3,99,0,2,0,0,0,19,0,81,0,0,0,0,0,0,0,0,0,3,0,0,0,2,0,0,0,19,0,78,0,0
제19대,JG77046J,이언주,李彦周,민주통합당,경기 광명시을,384,111,273,6,14,7,0,0,105,8,244,0,0,1,4,0,0,0,28,1,77,0,0,5,10,7,0,0,77,7,167,0,0
제19대,1O81498A,김형태,金亨泰,새누리당,경북 포항시남구울릉군,66,2,64,0,4,1,0,0,17,1,43,0,0,0,0,0,0,0,0,0,2,0,0,0,4,1,0,0,17,1,41,0,0
제19대,6YT83269,이명수,李明洙,자유선진당,충남 아산시,1423,262,1161,43,98,17,0,0,427,29,809,0,0,17,3,3,0,0,72,5,162,0,0,26,95,14,0,0,355,24,647,0,0
제19대,0582116P,이우현,李愚鉉,새누리당,경기 용인시갑,791,19,772,21,71,8,1,0,191,30,469,0,0,0,0,2,0,0,6,0,11,0,0,21,71,6,1,0,185,30,458,0,0
제19대,JZY9937U,김윤덕,金潤德,민주통합당,전북 전주시완산구갑,1082,63,1019,38,54,7,0,0,259,24,700,0,0,1,7,0,0,0,22,0,33,0,0,37,47,7,0,0,237,24,667,0,0
제19대,64G6894C,김정훈,金正薰,새누리당,부산 남구갑,270,43,227,9,51,1,0,0,62,10,137,0,0,4,1,1,0,0,13,1,23,0,0,5,50,0,0,0,49,9,114,0,0
제19대,J8545024,박민수,朴敏秀,민주통합당,전북 진안군무주군장수군임실군,1642,124,1518,28,82,12,0,0,422,34,1064,0,0,2,7,0,0,0,30,0,85,0,0,26,75,12,0,0,392,34,979,0,0
제19대,VO548788,유인태,柳寅泰,민주통합당,서울 도봉구을,262,9,253,5,10,2,0,0,53,3,189,0,0,0,0,0,0,0,1,0,8,0,0,5,10,2,0,0,52,3,181,0,0
제19대,3C23171A,진성준,陳聲準,민주통합당,비례대표,866,49,817,14,33,9,0,0,248,7,555,0,0,1,0,0,0,0,11,0,37,0,0,13,33,9,0,0,237,7,518,0,0
제19대,SVH30067,오제세,吳濟世,민주통합당,충북 청주시흥덕구갑,776,157,619,42,28,16,0,0,221,35,434,0,0,0,6,1,0,0,45,14,91,0,0,42,22,15,0,0,176,21,343,0,0
제19대,AJV31724,이학재,李鶴宰,새누리당,인천 서구강화군갑,473,28,445,12,63,5,0,0,115,11,267,0,0,0,0,0,0,0,9,2,17,0,0,12,63,5,0,0,106,9,250,0,0
제19대,GDG1847Z,권성동,權性東,새누리당,강원 강릉시,890,73,817,42,97,20,1,0,213,33,484,0,0,13,7,0,0,0,18,1,34,0,0,29,90,20,1,0,195,32,450,0,0
제19대,BUA6864N,유대운,劉大運,민주통합당,서울 강북구을,625,43,582,13,32,6,0,0,183,15,376,0,0,1,4,0,0,0,17,2,19,0,0,12,28,6,0,0,166,13,357,0,0
제19대,0X75519K,최봉홍,崔奉弘,새누리당,비례대표,1023,50,973,52,91,31,0,0,252,18,579,0,0,1,2,0,0,0,19,0,28,0,0,51,89,31,0,0,233,18,551,0,0
제19대,QZG38143,김춘진,金椿鎭,민주통합당,전북 고창군부안군,1484,138,1346,35,87,11,0,0,382,44,925,0,0,4,8,1,0,0,25,4,96,0,0,31,79,10,0,0,357,40,829,0,0
제19대,SU53086M,심상정,沈相정,통합진보당,경기 고양시덕양구갑,520,39,481,2,11,8,0,0,117,7,375,0,0,0,0,1,0,0,5,0,33,0,0,2,11,7,0,0,112,7,342,0,0
제19대,96A2025Q,안종범,安鍾範,새누리당,비례대표,188,14,174,5,44,0,0,0,64,5,70,0,0,0,4,0,0,0,9,1,0,0,0,5,40,0,0,0,55,4,70,0,0
제19대,2LY1272R,오병윤,吳秉潤,통합진보당,광주 서구을,207,14,193,3,5,3,0,0,46,1,149,0,0,0,0,0,0,0,4,0,10,0,0,3,5,3,0,0,42,1,139,0,0
제19대,XBJ9297Q,노영민,盧英敏,민주통합당,충북 청주시흥덕구을,663,52,611,32,39,8,0,0,168,22,394,0,0,2,2,0,0,0,18,0,30,0,0,30,37,8,0,0,150,22,364,0,0
제19대,4I848418,성완종,成完鍾,자유선진당,충남 서산시태안군,236,26,210,10,43,1,0,0,64,9,109,0,0,0,1,0,0,0,8,0,17,0,0,10,42,1,0,0,56,9,92,0,0
제19대,GMK1374L,이석현,李錫玄,민주통합당,경기 안양시동안구갑,420,41,379,18,15,5,0,0,102,6,274,0,0,0,5,2,0,0,8,0,26,0,0,18,10,3,0,0,94,6,248,0,0
제19대,UM51067K,인재근,印在謹,민주통합당,서울 도봉구갑,975,87,888,14,28,4,0,0,254,17,658,0,0,0,4,0,0,0,24,0,59,0,0,14,24,4,0,0,230,17,599,0,0
제19대,5KV82250,조경태,趙慶泰,민주통합당,부산 사하구을,377,69,308,13,13,3,0,0,99,5,244,0,0,0,3,0,0,0,21,0,45,0,0,13,10,3,0,0,78,5,199,0,0
제19대,9I451000,현영희,玄永姬,새누리당,비례대표,119,8,111,2,5,7,0,0,26,2,77,0,0,0,0,0,0,0,1,1,6,0,0,2,5,7,0,0,25,1,71,0,0
제19대,ZX891805,강석훈,姜錫勳,새누리당,서울 서초구을,550,27,523,16,69,6,0,0,140,18,301,0,0,0,2,0,0,0,6,2,17,0,0,16,67,6,0,0,134,16,284,0,0
제19대,0W194007,김영주,金榮珠,민주통합당,서울 영등포구갑,285,42,243,7,17,2,0,0,77,0,182,0,0,0,7,0,0,0,13,0,22,0,0,7,10,2,0,0,64,0,160,0,0
제19대,6V68130W,김종훈,金宗壎,새누리당,서울 강남구을,211,11,200,10,39,0,0,0,53,5,104,0,0,0,0,0,0,0,7,1,3,0,0,10,39,0,0,0,46,4,101,0,0
제19대,8VY63414,류성걸,柳性杰,새누리당,대구 동구갑,231,43,188,4,47,1,0,0,51,12,116,0,0,0,2,1,0,0,12,1,27,0,0,4,45,0,0,0,39,11,89,0,0
제19대,9CR4440H,배덕광,裵德光,새누리당,부산 해운대구기장군갑,221,22,199,4,7,2,0,0,39,16,153,0,0,0,0,0,0,0,2,0,20,0,0,4,7,2,0,0,37,16,133,0,0
제19대,TBB59984,조명철,趙明哲,새누리당,비례대표,788,54,734,20,58,10,0,0,191,18,491,0,0,0,2,2,0,0,13,1,36,0,0,20,56,8,0,0,178,17,455,0,0
제19대,KM010870,최동익,崔東益,민주통합당,비례대표,1108,136,972,18,39,6,0,0,339,14,692,0,0,0,2,0,0,0,63,0,71,0,0,18,37,6,0,0,276,14,621,0,0
제19대,2SE64657,이장우,李莊雨,새누리당,대전 동구,417,17,400,12,54,2,0,0,104,10,235,0,0,0,3,0,0,0,5,1,8,0,0,12,51,2,0,0,99,9,227,0,0
제19대,JR141579,정희수,鄭熙秀,새누리당,경북 영천시,1478,177,1301,34,117,20,0,0,392,38,877,0,0,1,13,3,0,0,41,5,114,0,0,33,104,17,0,0,351,33,763,0,0
제19대,97C8328D,민현주,閔炫珠,새누리당,비례대표,585,43,542,10,64,3,0,0,177,18,313,0,0,0,0,0,0,0,12,1,30,0,0,10,64,3,0,0,165,17,283,0,0
제19대,DMR40160,유일호,柳一鎬,새누리당,서울 송파구을,241,14,227,8,47,2,0,0,61,3,120,0,0,0,2,0,0,0,1,0,11,0,0,8,45,2,0,0,60,3,109,0,0
제19대,SBQ65245,이만우,李萬雨,새누리당,비례대표,1879,44,1835,30,123,18,0,0,580,49,1079,0,0,0,2,0,0,0,10,2,30,0,0,30,121,18,0,0,570,47,1049,0,0
제19대,N3Q3468A,김우남,金宇南,민주통합당,제주 제주시을,1602,235,1367,66,86,9,0,0,378,40,1023,0,0,13,17,2,0,0,70,5,128,0,0,53,69,7,0,0,308,35,895,0,0
제19대,1ZF7922T,김한길,金한길,민주통합당,,70,9,61,0,0,1,0,0,12,1,56,0,0,0,0,1,0,0,1,0,7,0,0,0,0,0,0,0,11,1,49,0,0
제19대,K3W33496,박광온,朴洸瑥,새정치민주연합,경기 수원시정,427,41,386,3,8,4,0,0,87,19,306,0,0,0,0,0,0,0,4,2,35,0,0,3,8,4,0,0,83,17,271,0,0
제19대,1TX50241,전하진,田夏鎭,새누리당,경기 성남시분당구을,484,21,463,10,66,4,1,0,138,16,249,0,0,0,3,1,0,0,8,1,8,0,0,10,63,3,1,0,130,15,241,0,0
제19대,3EF4589Q,문정림,文靜林,자유선진당,비례대표,978,72,906,36,88,4,0,0,266,20,564,0,0,10,9,0,0,0,34,2,17,0,0,26,79,4,0,0,232,18,547,0,0
제19대,XT18076X,박주선,朴柱宣,무소속,광주 동구,873,32,841,19,44,5,0,0,181,29,595,0,0,1,1,0,0,0,5,1,24,0,0,18,43,5,0,0,176,28,571,0,0
제19대,WAL2715Z,박창식,朴昌植,새누리당,비례대표,554,26,528,21,56,3,0,0,146,6,322,0,0,0,2,0,0,0,5,0,19,0,0,21,54,3,0,0,141,6,303,0,0
제19대,1XO42697,이재영,李在暎,새누리당,경기 평택시을,462,22,440,20,60,14,0,0,156,12,200,0,0,0,1,0,0,0,8,2,11,0,0,20,59,14,0,0,148,10,189,0,0
제19대,0ID22746,이진복,李珍福,새누리당,부산 동래구,569,34,535,12,74,2,0,0,150,15,316,0,0,0,3,0,0,0,11,1,19,0,0,12,71,2,0,0,139,14,297,0,0
제19대,M3Z17237,김재경,金在庚,새누리당,경남 진주시을,363,24,339,19,56,10,0,0,94,4,180,0,0,0,0,0,0,0,8,0,16,0,0,19,56,10,0,0,86,4,164,0,0
제19대,06K9071F,김제남,金霽南,통합진보당,비례대표,556,66,490,4,12,4,0,0,133,9,394,0,0,0,0,0,0,0,22,2,42,0,0,4,12,4,0,0,111,7,352,0,0
제19대,CKH5381Y,노철래,盧喆來,새누리당,경기 광주시,347,17,330,21,48,6,0,0,86,6,180,0,0,0,0,1,0,0,4,0,12,0,0,21,48,5,0,0,82,6,168,0,0
제19대,VWJ7674Q,배재정,裵在禎,민주통합당,비례대표,1296,42,1254,21,48,11,0,0,353,14,849,0,0,2,0,0,0,0,3,0,37,0,0,19,48,11,0,0,350,14,812,0,0
제19대,FY756149,심학봉,沈學鳳,새누리당,경북 구미시갑,429,6,423,10,61,6,0,0,122,11,219,0,0,1,2,0,0,0,2,0,1,0,0,9,59,6,0,0,120,11,218,0,0
제19대,NDH62175,이재오,李在五,새누리당,서울 은평구을,139,11,128,4,9,0,0,0,24,0,102,0,0,0,0,0,0,0,2,0,9,0,0,4,9,0,0,0,22,0,93,0,0
제19대,XQ98168F,강길부,姜吉夫,새누리당,울산 울주군,368,30,338,6,47,0,0,0,111,6,198,0,0,0,3,0,0,0,13,0,14,0,0,6,44,0,0,0,98,6,184,0,0
제19대,NNP30098,김기선,金起善,새누리당,강원 원주시갑,755,62,693,22,64,4,1,0,214,18,432,0,0,0,2,0,0,0,24,1,35,0,0,22,62,4,1,0,190,17,397,0,0
제19대,V772925Y,정호준,鄭皓駿,민주통합당,서울 중구,526,55,471,7,19,3,0,0,125,6,366,0,0,0,2,0,0,0,13,0,40,0,0,7,17,3,0,0,112,6,326,0,0
제19대,PTC5301T,민병주,閔丙珠,새누리당,비례대표,511,41,470,14,70,6,0,0,137,8,276,0,0,2,4,0,0,0,11,0,24,0,0,12,66,6,0,0,126,8,252,0,0
제19대,W4X85128,박대출,朴大出,새누리당,경남 진주시갑,402,34,368,12,53,4,0,0,108,13,212,0,0,0,1,0,0,0,7,2,24,0,0,12,52,4,0,0,101,11,188,0,0
제19대,LJJ52334,송광호,宋光浩,새누리당,충북 제천시단양군,315,18,297,11,52,4,0,0,95,8,145,0,0,0,0,0,0,0,10,0,8,0,0,11,52,4,0,0,85,8,137,0,0
제19대,8FC9697X,유기홍,柳基洪,민주통합당,서울 관악구갑,533,47,486,13,25,5,0,0,139,6,345,0,0,1,2,0,0,0,18,0,26,0,0,12,23,5,0,0,121,6,319,0,0
제19대,8IN46764,이주영,李柱榮,새누리당,경남 창원시마산합포구,339,21,318,11,45,5,0,0,60,5,213,0,0,0,2,0,0,0,2,0,17,0,0,11,43,5,0,0,58,5,196,0,0
제19대,GCA42857,주승용,朱昇鎔,민주통합당,전남 여수시을,1145,156,989,62,63,24,0,0,331,29,636,0,0,15,9,5,0,0,44,3,80,0,0,47,54,19,0,0,287,26,556,0,0
제19대,AHO78623,주영순,朱永順,새누리당,비례대표,738,35,703,25,69,32,0,0,224,21,367,0,0,1,2,1,0,0,12,1,18,0,0,24,67,31,0,0,212,20,349,0,0
제19대,F5U2979W,김학용,金學容,새누리당,경기 안성시,232,45,187,11,34,3,0,0,50,7,127,0,0,5,6,0,0,0,11,1,22,0,0,6,28,3,0,0,39,6,105,0,0
제19대,92I3002P,부좌현,夫佐炫,민주통합당,경기 안산시단원구을,1675,178,1497,29,57,14,0,0,439,33,1103,0,0,4,7,0,0,0,40,4,123,0,0,25,50,14,0,0,399,29,980,0,0
제19대,V0O5343U,우상호,禹相虎,민주통합당,서울 서대문구갑,194,36,158,3,11,2,0,0,40,2,136,0,0,0,4,1,0,0,12,0,19,0,0,3,7,1,0,0,28,2,117,0,0
제19대,HSW1214Q,이종배,李鍾培,새누리당,충북 충주시,316,21,295,4,11,2,0,0,54,9,236,0,0,0,0,0,0,0,2,2,17,0,0,4,11,2,0,0,52,7,219,0,0
제19대,3SP89633,천정배,千正培,무소속,광주 서구을,18,3,15,0,1,0,0,0,3,1,13,0,0,0,0,0,0,0,0,0,3,0,0,0,1,0,0,0,3,1,10,0,0
제19대,FI898377,이운룡,李雲龍,새누리당,비례대표,373,30,343,9,57,4,0,0,86,8,209,0,0,0,4,1,0,0,8,0,17,0,0,9,53,3,0,0,78,8,192,0,0
제19대,1WP9325U,강동원,姜東遠,통합진보당,전북 남원시순창군,1236,98,1138,20,42,14,0,0,309,32,819,0,0,0,0,1,0,0,27,1,69,0,0,20,42,13,0,0,282,31,750,0,0
제19대,8I61593E,강석호,姜碩鎬,새누리당,경북 영양군영덕군봉화군울진군,725,41,684,26,84,13,0,0,195,23,384,0,0,1,11,1,0,0,15,0,13,0,0,25,73,12,0,0,180,23,371,0,0
제19대,LAU79556,신경림,辛瓊林,새누리당,비례대표,652,65,587,22,65,6,0,0,177,11,371,0,0,1,3,2,0,0,30,0,29,0,0,21,62,4,0,0,147,11,342,0,0
제19대,M7O7878U,신정훈,辛正勳,새정치민주연합,전남 나주시화순군,336,17,319,6,9,3,0,0,63,10,245,0,0,0,1,0,0,0,2,0,14,0,0,6,8,3,0,0,61,10,231,0,0
제19대,NR221895,심윤조,沈允肇,새누리당,서울 강남구갑,301,25,276,10,40,0,0,0,71,4,176,0,0,0,0,0,0,0,7,1,17,0,0,10,40,0,0,0,64,3,159,0,0
제19대,A486635H,안상수,安相洙,새누리당,인천 서구강화군을,60,1,59,0,0,0,0,0,7,0,53,0,0,0,0,0,0,0,0,0,1,0,0,0,0,0,0,0,7,0,52,0,0
제19대,BHA7868N,이노근,李老根,새누리당,서울 노원구갑,1364,138,1226,28,89,23,0,0,390,37,797,0,0,2,6,0,0,0,51,2,77,0,0,26,83,23,0,0,339,35,720,0,0
제19대,GW55008L,홍의락,洪宜洛,민주통합당,비례대표,346,18,328,4,14,4,0,0,86,7,231,0,0,0,0,0,0,0,4,1,13,0,0,4,14,4,0,0,82,6,218,0,0
제19대,06L2365K,홍일표,洪日杓,새누리당,인천 남구갑,306,32,274,7,52,6,0,0,77,9,155,0,0,2,1,0,0,0,8,1,20,0,0,5,51,6,0,0,69,8,135,0,0
제19대,5CO4531H,유은혜,兪銀惠,민주통합당,경기 고양시일산동구,662,41,621,8,28,7,0,0,174,4,441,0,0,3,2,0,0,0,6,0,30,0,0,5,26,7,0,0,168,4,411,0,0
제19대,0135473I,이군현,李君賢,새누리당,경남 통영시고성군,189,12,177,5,42,4,0,0,24,2,112,0,0,0,3,1,0,0,3,0,5,0,0,5,39,3,0,0,21,2,107,0,0
제19대,ZYH1940A,이상민,李相珉,민주통합당,대전 유성구,541,83,458,17,23,10,0,0,132,5,354,0,0,2,3,0,0,0,21,1,56,0,0,15,20,10,0,0,111,4,298,0,0
제19대,K5F2023J,이학영,李學永,민주통합당,경기 군포시,943,36,907,38,35,5,0,0,265,11,589,0,0,0,1,0,0,0,7,0,28,0,0,38,34,5,0,0,258,11,561,0,0
제19대,I0S53762,하태경,河泰慶,새누리당,부산 해운대구기장군을,389,28,361,8,61,3,0,0,100,3,214,0,0,1,0,0,0,0,3,0,24,0,0,7,61,3,0,0,97,3,190,0,0
